"Postcode","Number of Individuals (Taxable)","Average Individual Income (Taxable)","Number of Individuals with Private Health Insurance (Taxable)","Percentage of Postcode without PHI (Taxable)","Number of Individuals with Low Income Tax offset (Taxable)","Number of Individuals on Government Allowances and Payments (Taxable)","Percentage of Postcode recieving Government Allowances and Payments (Taxable)","Average Individual Government Allowances and Payments (Taxable)","Number of Individuals (Non-Taxable)","Average Individual Income (Non-Taxable)","Number of Individuals with Private Health Insurance (Non-Taxable)","Percentage of Postcode without PHI (Non-Taxable)","Number of Individuals with Low Income Tax offset (Non-Taxable)","Number of Individuals on Government Allowances and Payments (Non-Taxable)","Percentage of Postcode recieving Government Allowances and Payments (Non-Taxable)","Average Individual Government Allowances and Payments (Non-Taxable)","Number of Individuals (Total)","Number of Individuals with Private Health Insurance (Total)","Percentage of Postcode without PHI (Total)","Number of Individuals with Low Income Tax offset (Total)","Number of Individuals on Government Allowances and Payments (Total)","Percentage of Postcode recieving Government Allowances and Payments (Total)","Number of persons earning $18,200 or less","Number of persons earning $18,201 to $37,000","Number of persons earning $37,001 to $80,000","Number of persons earning $80,001 to $180,000","Number of persons earning $180,000 or more","Percentage of persons earning $18,200 or less","Percentage of persons earning $18,201 to $37,000","Percentage of persons earning $37,001 to $80,000","Percentage of persons earning $80,001 to $180,000","Percentage of persons earning $180,000 or more"
"3000",13203,79770,870,93,8203,417,3,4413,8382,9585,159,98,989,333,4,6858,21585,1029,95,9192,750,97,7490,4817,5762,2879,637,35,22,27,13,3
"3002",2921,143928,224,92,1179,83,3,4332,665,11012,32,95,87,57,9,6547,3586,256,93,1266,140,96,541,536,1152,908,449,15,15,32,25,13
"3003",2588,78708,184,93,1451,121,5,5051,983,10743,26,97,141,81,8,7115,3571,210,94,1592,202,94,825,726,1171,714,135,23,20,33,20,4
"3004",5426,109702,456,92,2481,138,3,4510,1515,9399,53,97,205,103,7,7488,6941,509,93,2686,241,97,1266,1106,2292,1737,540,18,16,33,25,8
"3006",9330,89804,806,91,4850,256,3,4494,2959,9697,96,97,383,176,6,7069,12289,902,93,5233,432,96,2556,2218,4176,2752,587,21,18,34,22,5
"3008",5455,89987,419,92,2715,108,2,4326,1709,9406,85,95,238,77,5,7019,7164,504,93,2953,185,97,1478,1262,2326,1721,377,21,18,32,24,5
"3011",9878,64440,595,94,6303,747,8,5070,3045,11861,77,97,509,626,21,7730,12923,672,95,6812,1373,89,2360,3213,4915,2234,201,18,25,38,17,2
"3012",11755,64948,642,95,7405,755,6,5169,3254,11805,58,98,545,634,19,7723,15009,700,95,7950,1389,91,2483,3520,6065,2725,216,17,23,40,18,1
"3013",7529,81177,541,93,3728,298,4,4864,1590,11822,51,97,262,280,18,7419,9119,592,94,3990,578,94,1212,1698,3315,2494,400,13,19,36,27,4
"3015",8558,83096,617,93,4143,341,4,4690,1866,12127,63,97,329,260,14,7505,10424,680,93,4472,601,94,1402,1903,3718,2924,477,13,18,36,28,5
"3016",7602,100281,547,93,3493,254,3,4586,2118,11731,90,96,329,233,11,6777,9720,637,93,3822,487,95,1599,1868,2946,2499,808,16,19,30,26,8
"3018",5938,73259,376,94,3349,289,5,4494,1709,11772,44,97,230,209,12,8057,7647,420,95,3579,498,93,1293,1563,2953,1655,183,17,20,39,22,2
"3019",3029,53724,112,96,2309,292,10,4812,1248,12838,14,99,235,350,28,7745,4277,126,97,2544,642,85,911,1259,1697,387,23,21,29,40,9,1
"3020",15582,54085,555,96,11870,1324,8,4945,6094,12604,90,99,1120,1390,23,7726,21676,645,97,12990,2714,87,4439,6241,8830,2078,88,20,29,41,10,0
"3021",17729,51770,400,98,14075,1679,9,4959,7224,12778,93,99,1288,1760,24,7764,24953,493,98,15363,3439,86,5262,7486,10214,1920,71,21,30,41,8,0
"3022",1490,56051,49,97,1091,124,8,4686,447,12910,5,99,89,112,25,8072,1937,54,97,1180,236,88,319,534,856,220,8,16,28,44,11,0
"3023",25376,61572,922,96,16843,1455,6,4616,7324,11775,133,98,1278,1448,20,7226,32700,1055,97,18121,2903,91,5575,7685,14093,5071,276,17,24,43,16,1
"3024",9664,59617,356,96,6539,630,7,4751,2601,12412,39,99,423,591,23,7527,12265,395,97,6962,1221,90,1935,2872,5550,1844,64,16,23,45,15,1
"3025",4530,65900,247,95,2807,267,6,4953,1311,12648,33,97,235,255,19,7488,5841,280,95,3042,522,91,936,1424,2321,1082,78,16,24,40,19,1
"3026",133,92187,5,96,69,4,3,6241,36,13543,0,100,11,4,11,10748,169,5,97,80,8,95,24,33,64,36,12,14,20,38,21,7
"3027",3198,68113,168,95,1871,90,3,4415,835,9578,21,97,146,83,10,7300,4033,189,95,2017,173,96,677,831,1587,892,46,17,21,39,22,1
"3028",12508,60248,554,96,8422,702,6,4772,3537,12056,63,98,599,619,18,7346,16045,617,96,9021,1321,92,2641,3879,6958,2463,104,16,24,43,15,1
"3029",38622,59241,1478,96,26625,1963,5,4545,11732,11549,195,98,1942,1976,17,7155,50354,1673,97,28567,3939,92,9017,12005,22099,6957,276,18,24,44,14,1
"3030",42926,67351,2123,95,26262,2067,5,4603,12416,11360,304,98,2077,1981,16,7338,55342,2427,96,28339,4048,93,9495,12157,22346,10400,944,17,22,40,19,2
"3031",8713,76806,601,93,4648,538,6,4860,2238,12258,79,96,320,515,23,7417,10951,680,94,4968,1053,90,1726,2190,4068,2611,356,16,20,37,24,3
"3032",14075,78205,885,94,7904,797,6,4955,3891,11578,118,97,582,663,17,7765,17966,1003,94,8486,1460,92,3052,3814,6605,3792,703,17,21,37,21,4
"3033",6197,70949,340,95,3675,240,4,4784,1887,12481,49,97,307,203,11,7124,8084,389,95,3982,443,95,1356,1898,3072,1560,198,17,23,38,19,2
"3034",4768,67366,216,95,2949,218,5,4596,1572,12558,28,98,251,208,13,7180,6340,244,96,3200,426,93,1130,1521,2440,1136,113,18,24,38,18,2
"3036",2903,81486,142,95,1563,97,3,4412,994,12279,26,97,148,88,9,6621,3897,168,96,1711,185,95,709,875,1327,837,149,18,22,34,21,4
"3037",21449,61935,763,96,14258,1138,5,4406,6027,11864,85,99,1121,1128,19,7081,27476,848,97,15379,2266,92,4538,6540,11739,4397,262,17,24,43,16,1
"3038",13008,64450,546,96,8337,604,5,4417,3934,12070,89,98,725,623,16,7040,16942,635,96,9062,1227,93,2917,4110,6787,2910,218,17,24,40,17,1
"3039",7214,88242,493,93,3624,279,4,4871,1888,11588,61,97,268,218,12,6936,9102,554,94,3892,497,95,1477,1749,3106,2231,539,16,19,34,25,6
"3040",13231,87754,820,94,6903,516,4,4241,3545,11581,135,96,603,361,10,6960,16776,955,94,7506,877,95,2674,3378,5973,3758,993,16,20,36,22,6
"3041",6105,82390,369,94,3224,199,3,4477,1649,11994,51,97,244,159,10,6753,7754,420,95,3468,358,95,1224,1608,2735,1819,368,16,21,35,23,5
"3042",7186,69482,439,94,4226,319,4,4509,2073,12341,61,97,313,254,12,7304,9259,500,95,4539,573,94,1526,2021,3686,1831,195,16,22,40,20,2
"3043",7674,61561,363,95,5159,441,6,4925,2310,12744,53,98,376,348,15,7340,9984,416,96,5535,789,92,1647,2439,4313,1488,97,16,24,43,15,1
"3044",12111,69936,687,94,7095,517,4,4390,3204,11803,88,97,506,446,14,7611,15315,775,95,7601,963,94,2409,3375,6023,3201,307,16,22,39,21,2
"3046",13351,60856,675,95,9019,698,5,4693,4519,11991,94,98,731,695,15,7180,17870,769,96,9750,1393,92,3413,4541,7075,2674,167,19,25,40,15,1
"3047",5169,49844,102,98,4249,586,11,5485,2411,13072,25,99,426,662,27,7933,7580,127,98,4675,1248,84,1741,2454,2885,483,17,23,32,38,6,0
"3048",4649,50001,111,98,3749,579,12,5017,1993,13191,13,99,389,631,32,7756,6642,124,98,4138,1210,82,1413,2169,2608,441,11,21,33,39,7,0
"3049",4258,62874,151,96,2821,220,5,4586,1139,12658,17,99,198,164,14,6701,5397,168,97,3019,384,93,829,1310,2333,864,61,15,24,43,16,1
"3051",5722,78335,389,93,3350,449,8,5076,2217,10994,58,97,289,404,18,8097,7939,447,94,3639,853,89,1824,1827,2626,1385,277,23,23,33,17,3
"3052",2431,86450,179,93,1409,190,8,5118,982,10726,28,97,111,191,19,7739,3413,207,94,1520,381,89,822,740,1103,575,173,24,22,32,17,5
"3053",5137,75778,334,93,3076,384,7,5098,2535,10473,67,97,279,394,16,8229,7672,401,95,3355,778,90,2166,1746,2277,1224,259,28,23,30,16,3
"3054",4577,90315,312,93,2416,328,7,5243,1269,11858,49,96,202,216,17,7606,5846,361,94,2618,544,91,959,1297,1944,1250,396,16,22,33,21,7
"3055",6715,70121,425,94,4032,498,7,4719,1856,12052,52,97,273,384,21,7706,8571,477,94,4305,882,90,1451,1974,3272,1660,214,17,23,38,19,2
"3056",12821,71173,817,94,7586,937,7,4719,3517,11538,113,97,522,695,20,7428,16338,930,94,8108,1632,90,2805,3688,6126,3244,475,17,23,37,20,3
"3057",6248,70802,450,93,3618,468,7,5082,1608,11690,53,97,229,363,23,7316,7856,503,94,3847,831,89,1296,1705,3026,1618,211,16,22,39,21,3
"3058",15415,67285,833,95,9510,974,6,4886,4550,12341,117,97,782,864,19,7608,19965,950,95,10292,1838,91,3400,4906,7578,3710,371,17,25,38,19,2
"3059",7367,67991,331,96,4552,257,3,4565,1983,11417,41,98,375,292,15,6522,9350,372,96,4927,549,94,1490,2261,3680,1716,203,16,24,39,18,2
"3060",4455,57985,141,97,3197,290,7,4691,1842,11853,30,98,299,326,18,7664,6297,171,97,3496,616,90,1386,1797,2311,759,44,22,29,37,12,1
"3061",1471,53647,33,98,1140,138,9,4877,664,12809,11,98,121,147,22,6775,2135,44,98,1261,285,87,476,675,788,176,20,22,32,37,8,1
"3062",85,116086,4,95,40,5,6,1994,13,12527,0,100,3,0,0,NA,98,4,96,43,5,95,10,16,41,17,14,10,16,42,17,14
"3063",285,76079,16,94,171,10,4,6853,83,10457,4,95,13,7,8,9607,368,20,95,184,17,95,64,78,145,65,16,17,21,39,18,4
"3064",28131,56829,856,97,20290,1798,6,4773,8211,12149,110,99,1482,1728,21,7109,36342,966,97,21772,3526,90,6191,9589,15893,4500,169,17,26,44,12,0
"3065",5341,89011,416,92,2862,375,7,5360,1421,11288,37,97,212,285,20,7793,6762,453,93,3074,660,90,1131,1474,2308,1438,411,17,22,34,21,6
"3066",4351,75890,358,92,2439,295,7,5054,1121,11502,36,97,161,213,19,8333,5472,394,93,2600,508,91,896,1142,2053,1196,185,16,21,38,22,3
"3067",4622,78665,350,92,2521,268,6,4716,1115,10794,36,97,147,137,12,7531,5737,386,93,2668,405,93,910,1068,2262,1280,217,16,19,39,22,4
"3068",9809,92200,727,93,4995,563,6,4857,2431,11162,114,95,340,417,17,7503,12240,841,93,5335,980,92,1883,2390,4269,2830,868,15,20,35,23,7
"3070",12282,81800,817,93,6523,696,6,4747,3129,11894,107,97,464,616,20,7252,15411,924,94,6987,1312,91,2413,3155,5555,3518,770,16,20,36,23,5
"3071",8903,70456,493,94,5341,595,7,5113,2181,12604,49,98,368,459,21,7819,11084,542,95,5709,1054,90,1628,2633,4302,2244,277,15,24,39,20,2
"3072",14325,65440,754,95,8993,972,7,4995,4271,12178,100,98,682,857,20,7790,18596,854,95,9675,1829,90,3233,4497,7253,3322,291,17,24,39,18,2
"3073",19099,59533,769,96,13155,1206,6,5060,6432,12367,135,98,1000,1166,18,7643,25531,904,96,14155,2372,91,4848,6571,10426,3491,195,19,26,41,14,1
"3074",6842,54028,212,97,5269,519,8,4651,2705,12637,44,98,468,575,21,7467,9547,256,97,5737,1094,89,1955,2765,3940,843,44,20,29,41,9,0
"3075",7473,54391,224,97,5643,524,7,5098,2784,12381,32,99,476,536,19,7369,10257,256,98,6119,1060,90,2049,2870,4289,1005,44,20,28,42,10,0
"3076",13147,56784,447,97,9524,787,6,4530,4062,12164,72,98,717,792,19,7243,17209,519,97,10241,1579,91,3029,4518,7528,2053,81,18,26,44,12,0
"3078",5694,89274,325,94,2972,250,4,4719,1442,12020,51,96,240,234,16,7395,7136,376,95,3212,484,93,1103,1424,2511,1658,440,15,20,35,23,6
"3079",8025,104236,495,94,3764,240,3,4477,2317,11060,99,96,346,218,9,6547,10342,594,94,4110,458,96,1775,2012,3208,2473,874,17,19,31,24,8
"3081",4996,61092,211,96,3392,385,8,5201,1721,12517,38,98,266,416,24,8085,6717,249,96,3658,801,88,1287,1764,2633,949,84,19,26,39,14,1
"3082",13414,59649,523,96,9246,721,5,4509,3957,12012,92,98,662,698,18,7084,17371,615,96,9908,1419,92,3002,4282,7490,2458,139,17,25,43,14,1
"3083",12159,62565,551,95,8148,611,5,4953,4744,11412,113,98,698,649,14,7388,16903,664,96,8846,1260,93,3677,4294,6290,2408,234,22,25,37,14,1
"3084",11837,83977,723,94,6192,406,3,4020,3903,11535,151,96,546,358,9,6695,15740,874,94,6738,764,95,2926,3343,5212,3508,751,19,21,33,22,5
"3085",6145,75290,399,94,3437,197,3,4121,2005,11612,74,96,291,196,10,7005,8150,473,94,3728,393,95,1530,1701,2987,1681,251,19,21,37,21,3
"3087",4047,66662,232,94,2445,175,4,5102,1112,11863,27,98,143,138,12,7422,5159,259,95,2588,313,94,846,1153,2085,1009,66,16,22,40,20,1
"3088",12829,70251,727,94,7428,477,4,4170,3741,11994,109,97,573,406,11,6841,16570,836,95,8001,883,95,2790,3660,6280,3500,340,17,22,38,21,2
"3089",6005,72262,346,94,3388,186,3,3905,1528,11922,63,96,223,177,12,6334,7533,409,95,3611,363,95,1165,1675,2818,1674,201,15,22,37,22,3
"3090",1216,93236,73,94,615,25,2,2818,340,12905,10,97,67,31,9,6407,1556,83,95,682,56,96,239,336,528,356,97,15,22,34,23,6
"3091",817,90099,46,94,439,10,1,2772,257,10748,11,96,45,22,9,6442,1074,57,95,484,32,97,182,256,348,216,72,17,24,32,20,7
"3093",1858,92095,125,93,977,50,3,5436,559,9968,24,96,73,47,8,6990,2417,149,94,1050,97,96,421,487,863,519,127,17,20,36,21,5
"3094",4237,69955,273,94,2441,176,4,3808,1211,12113,47,96,174,100,8,7077,5448,320,94,2615,276,95,910,1190,2062,1191,95,17,22,38,22,2
"3095",14035,81240,909,94,7438,432,3,3939,4220,11600,150,96,643,400,9,6671,18255,1059,94,8081,832,95,3230,3958,6022,4203,842,18,22,33,23,5
"3096",892,67088,41,95,556,39,4,4442,274,12772,4,99,40,31,11,7014,1166,45,96,596,70,94,204,292,430,220,20,17,25,37,19,2
"3097",694,113371,43,94,374,22,3,4455,247,12329,6,98,36,22,9,6021,941,49,95,410,44,95,181,231,265,184,80,19,25,28,20,9
"3099",2285,69494,115,95,1371,93,4,4443,758,11829,26,97,138,83,11,6899,3043,141,95,1509,176,94,551,781,1065,573,73,18,26,35,19,2
"3101",12469,132079,747,94,5582,387,3,4483,3872,9961,184,95,543,322,8,6860,16341,931,94,6125,709,96,3101,3042,4696,3577,1925,19,19,29,22,12
"3102",3164,101006,173,95,1514,96,3,4215,990,11190,30,97,148,92,9,6549,4154,203,95,1662,188,95,768,821,1252,915,398,18,20,30,22,10
"3103",7315,112305,451,94,3535,198,3,4609,2884,10583,89,97,354,211,7,6692,10199,540,95,3889,409,96,2284,2079,2882,2041,913,22,20,28,20,9
"3104",9365,95395,503,95,4633,242,3,4640,3629,10368,136,96,534,289,8,6610,12994,639,95,5167,531,96,2857,2742,3718,2735,942,22,21,29,21,7
"3105",4753,81552,245,95,2723,156,3,4953,1811,12696,52,97,273,171,9,7187,6564,297,95,2996,327,95,1310,1555,2201,1227,271,20,24,34,19,4
"3106",7671,93110,449,94,4063,227,3,4368,3090,11620,106,97,487,241,8,6605,10761,555,95,4550,468,96,2300,2473,3200,2120,668,21,23,30,20,6
"3107",5613,76733,302,95,3168,189,3,4556,2328,11710,63,97,316,210,9,7544,7941,365,95,3484,399,95,1743,1861,2533,1524,280,22,23,32,19,4
"3108",8672,76661,460,95,5340,335,4,4930,4093,11762,101,98,600,385,9,7389,12765,561,96,5940,720,94,3049,3316,3994,2018,388,24,26,31,16,3
"3109",11772,72023,556,95,7057,427,4,4274,5161,11450,168,97,702,499,10,6821,16933,724,96,7759,926,95,3964,4149,5462,2858,500,23,25,32,17,3
"3111",5480,93338,269,95,2938,168,3,4302,2091,11732,71,97,325,183,9,6033,7571,340,96,3263,351,95,1554,1746,2367,1459,445,21,23,31,19,6
"3113",4173,90664,239,94,2169,104,2,4183,1258,11841,54,96,162,78,6,6243,5431,293,95,2331,182,97,1009,1165,1708,1177,372,19,21,31,22,7
"3114",1870,109711,102,95,862,43,2,4011,626,11268,19,97,91,37,6,6360,2496,121,95,953,80,97,492,502,701,551,250,20,20,28,22,10
"3115",2070,93014,122,94,1097,50,2,3688,638,9647,26,96,95,43,7,5621,2708,148,95,1192,93,97,491,605,868,578,166,18,22,32,21,6
"3116",4635,67129,206,96,2911,201,4,4476,1492,12358,54,96,194,164,11,7038,6127,260,96,3105,365,94,1126,1458,2356,1066,121,18,24,38,17,2
"3121",17493,102821,1409,92,8564,860,5,4726,3527,10846,151,96,554,548,16,7537,21020,1560,93,9118,1408,93,2743,3677,7892,5477,1231,13,17,38,26,6
"3122",12502,122615,832,93,5917,526,4,4599,3425,10585,131,96,477,350,10,7021,15927,963,94,6394,876,94,2781,2948,5056,3566,1576,17,19,32,22,10
"3123",7266,116232,492,93,3326,293,4,4756,2028,11075,79,96,271,192,9,6531,9294,571,94,3597,485,95,1600,1698,2838,2184,974,17,18,31,23,10
"3124",11135,132711,743,93,5003,337,3,4328,3714,11050,127,97,524,329,9,6162,14849,870,94,5527,666,96,2884,2869,4141,3382,1573,19,19,28,23,11
"3125",5234,73605,302,94,3124,261,5,5259,2477,11390,69,97,338,262,11,7254,7711,371,95,3462,523,93,1898,1952,2292,1332,237,25,25,30,17,3
"3126",4134,167851,235,94,1672,116,3,4330,1311,2803,61,95,186,94,7,6016,5445,296,95,1858,210,96,1016,988,1378,1253,810,19,18,25,23,15
"3127",9172,106536,570,94,4263,269,3,4084,3030,11301,99,97,423,264,9,5929,12202,669,95,4686,533,96,2372,2352,3565,2748,1165,19,19,29,23,10
"3128",7519,71985,412,95,4556,331,4,4426,3375,11023,105,97,469,343,10,7079,10894,517,95,5025,674,94,2684,2623,3422,1825,340,25,24,31,17,3
"3129",7039,76737,384,95,4020,227,3,4312,2772,11255,85,97,365,281,10,7228,9811,469,95,4385,508,95,2141,2258,3172,1869,371,22,23,32,19,4
"3130",13830,78172,799,94,7648,485,4,4314,5122,11393,167,97,672,477,9,6882,18952,966,95,8320,962,95,3882,4260,6135,3932,743,20,22,32,21,4
"3131",9291,68590,503,95,5670,372,4,4269,3570,11634,117,97,494,406,11,7187,12861,620,95,6164,778,94,2734,3000,4548,2318,261,21,23,35,18,2
"3132",7510,72740,451,94,4279,275,4,4594,2524,11496,81,97,341,272,11,6929,10034,532,95,4620,547,95,1914,2160,3621,2103,236,19,22,36,21,2
"3133",9457,72694,504,95,5555,303,3,4276,4070,10909,111,97,501,337,8,6686,13527,615,95,6056,640,95,3163,3102,4439,2470,353,23,23,33,18,3
"3134",15111,72491,852,94,9048,666,4,4132,4840,11441,141,97,638,550,11,7046,19951,993,95,9686,1216,94,3735,4559,7373,3723,561,19,23,37,19,3
"3135",8658,68354,442,95,5215,357,4,4647,2863,11670,87,97,400,347,12,6814,11521,529,95,5615,704,94,2176,2599,4358,2157,231,19,23,38,19,2
"3136",19946,65906,1011,95,12605,907,5,4336,6289,12223,194,97,881,782,12,7040,26235,1205,95,13486,1689,94,4640,6210,10342,4604,439,18,24,39,18,2
"3137",6237,61486,279,96,4216,270,4,4172,1822,12828,54,97,306,230,13,6680,8059,333,96,4522,500,94,1303,1981,3484,1211,80,16,25,43,15,1
"3138",9992,62453,470,95,6586,505,5,4291,2879,12184,77,97,413,389,14,6578,12871,547,96,6999,894,93,2189,3013,5436,2094,139,17,23,42,16,1
"3139",6437,61267,255,96,4462,276,4,4315,2087,12005,55,97,335,274,13,7095,8524,310,96,4797,550,94,1546,2268,3437,1164,109,18,27,40,14,1
"3140",7705,65147,340,96,5075,327,4,4584,2368,12435,54,98,346,271,11,6969,10073,394,96,5421,598,94,1729,2488,4105,1588,163,17,25,41,16,2
"3141",14269,120185,1181,92,6967,573,4,4775,3318,10747,181,95,487,388,12,7329,17587,1362,92,7454,961,95,2706,3014,6352,4116,1399,15,17,36,23,8
"3142",8048,236671,473,94,3049,197,2,4495,2015,7473,88,96,291,154,8,7591,10063,561,94,3340,351,97,1546,1657,2684,2346,1830,15,16,27,23,18
"3143",4986,136525,288,94,2212,172,3,4669,1185,11411,61,95,190,89,8,6801,6171,349,94,2402,261,96,887,1073,2055,1434,722,14,17,33,23,12
"3144",6185,148626,336,95,2498,160,3,4869,1597,10218,73,95,200,131,8,6657,7782,409,95,2698,291,96,1266,1241,2194,1908,1173,16,16,28,25,15
"3145",10506,109595,652,94,4952,304,3,4056,3331,10307,105,97,454,280,8,6732,13837,757,95,5406,584,96,2633,2627,4100,3109,1368,19,19,30,22,10
"3146",12459,115798,737,94,5564,310,2,4210,3570,11213,147,96,493,283,8,7000,16029,884,94,6057,593,96,2772,2911,4855,3719,1772,17,18,30,23,11
"3147",6374,92971,417,93,3161,217,3,4692,2180,11444,68,97,311,199,9,6179,8554,485,94,3472,416,95,1683,1761,2523,2012,575,20,21,29,24,7
"3148",3899,67873,212,95,2445,220,6,4531,1274,11298,35,97,198,190,15,7604,5173,247,95,2643,410,92,971,1243,1929,921,109,19,24,37,18,2
"3149",14642,77784,785,95,8195,480,3,4288,6070,11120,182,97,807,502,8,6552,20712,967,95,9002,982,95,4717,4611,6532,4096,756,23,22,32,20,4
"3150",24859,76578,1191,95,14309,770,3,4380,11528,10883,345,97,1501,980,9,6503,36387,1536,96,15810,1750,95,8952,8337,11350,6538,1210,25,23,31,18,3
"3151",4062,66446,188,95,2591,157,4,4523,1850,11134,43,98,214,187,10,7265,5912,231,96,2805,344,94,1443,1483,1948,920,118,24,25,33,16,2
"3152",14776,67335,724,95,9217,663,4,4366,5614,11586,181,97,838,619,11,6872,20390,905,96,10055,1282,94,4268,4875,7419,3425,403,21,24,36,17,2
"3153",9078,60340,390,96,6244,491,5,4319,2665,12223,58,98,391,429,16,7559,11743,448,96,6635,920,92,1964,2707,5373,1598,101,17,23,46,14,1
"3154",2029,65987,91,96,1274,79,4,4987,588,13094,24,96,95,70,12,7608,2617,115,96,1369,149,94,424,599,1091,468,35,16,23,42,18,1
"3155",9904,59960,434,96,6851,552,6,4221,2946,12516,81,97,410,476,16,7162,12850,515,96,7261,1028,92,2148,3107,5681,1828,86,17,24,44,14,1
"3156",17574,66398,824,95,11242,823,5,4007,5063,11785,140,97,751,636,13,6790,22637,964,96,11993,1459,94,3853,5339,9179,3857,409,17,24,41,17,2
"3158",3246,65484,137,96,2021,142,4,4049,974,12535,19,98,162,141,14,7284,4220,156,96,2183,283,93,725,1002,1677,744,72,17,24,40,18,2
"3159",1175,67705,58,95,729,36,3,4687,359,11982,15,96,58,51,14,6721,1534,73,95,787,87,94,266,365,599,266,38,17,24,39,17,2
"3160",4187,67595,194,95,2570,197,5,4319,1314,12278,48,96,223,157,12,6847,5501,242,96,2793,354,94,973,1323,2121,979,105,18,24,39,18,2
"3161",7947,113322,463,94,3658,267,3,4884,2211,7958,90,96,352,271,12,6672,10158,553,95,4010,538,95,1691,1891,3203,2383,990,17,19,32,23,10
"3162",8995,98595,577,94,4489,256,3,4753,2702,11559,123,95,429,276,10,6891,11697,700,94,4918,532,95,1991,2473,3757,2620,856,17,21,32,22,7
"3163",14908,75904,944,94,8332,502,3,4583,4688,11205,152,97,669,476,10,6806,19596,1096,94,9001,978,95,3637,4053,7134,4089,683,19,21,36,21,3
"3165",12117,75406,705,94,6812,404,3,4432,3825,11511,135,96,558,421,11,6863,15942,840,95,7370,825,95,2876,3575,5510,3422,559,18,22,35,21,4
"3166",10444,70438,568,95,6196,437,4,4714,3228,11008,87,97,482,422,13,7108,13672,655,95,6678,859,94,2536,3022,5095,2691,328,19,22,37,20,2
"3167",4069,66862,193,95,2572,174,4,4524,1378,11933,37,97,222,172,12,6683,5447,230,96,2794,346,94,1023,1330,2080,925,89,19,24,38,17,2
"3168",6298,59548,271,96,4411,310,5,4656,3180,10427,64,98,379,347,11,7684,9478,335,96,4790,657,93,2642,2372,3261,1111,92,28,25,34,12,1
"3169",7750,57002,304,96,5598,378,5,4470,2948,11533,43,99,467,406,14,6853,10698,347,97,6065,784,93,2276,2849,4303,1207,63,21,27,40,11,1
"3170",8247,68266,409,95,5204,314,4,4424,2850,11565,76,97,430,316,11,7141,11097,485,96,5634,630,94,2176,2491,4372,1878,180,20,22,39,17,2
"3171",7172,51347,210,97,5771,516,7,4636,3342,11689,51,98,582,635,19,7388,10514,261,98,6353,1151,89,2511,3215,3969,781,38,24,31,38,7,0
"3172",9289,60023,342,96,6567,502,5,4504,3419,12170,67,98,520,573,17,6976,12708,409,97,7087,1075,92,2553,3315,5052,1641,147,20,26,40,13,1
"3173",10721,60949,413,96,7429,533,5,4195,3469,11744,70,98,580,591,17,7036,14190,483,97,8009,1124,92,2652,3364,6093,1932,149,19,24,43,14,1
"3174",13991,51853,407,97,11095,1018,7,4896,5185,12050,75,99,854,998,19,7442,19176,482,97,11949,2016,89,3895,5427,8330,1471,53,20,28,43,8,0
"3175",18761,52367,482,97,14849,1746,9,4751,7255,12404,107,99,1247,1638,23,7552,26016,589,98,16096,3384,87,5376,7848,10605,2066,121,21,30,41,8,0
"3177",3530,48761,68,98,2924,401,11,4753,1298,12982,5,100,219,363,28,7743,4828,73,98,3143,764,84,937,1536,2071,278,6,19,32,43,6,0
"3178",16303,67263,813,95,10093,637,4,4177,4820,11358,128,97,747,587,12,6630,21123,941,96,10840,1224,94,3704,4808,8285,3943,383,18,23,39,19,2
"3179",2694,63172,112,96,1824,142,5,4135,828,12232,17,98,129,127,15,7049,3522,129,96,1953,269,92,610,912,1409,550,41,17,26,40,16,1
"3180",3287,64156,158,95,2119,159,5,4360,1159,11968,22,98,158,134,12,6841,4446,180,96,2277,293,93,882,1065,1728,715,56,20,24,39,16,1
"3181",11885,86343,924,92,6207,549,5,4737,3673,10949,110,97,470,343,9,7350,15558,1034,93,6677,892,94,3091,2823,5439,3397,808,20,18,35,22,5
"3182",13263,83933,983,93,7337,667,5,4995,3820,11330,109,97,554,440,12,8015,17083,1092,94,7891,1107,94,3093,3481,6239,3528,742,18,20,37,21,4
"3183",9571,79905,655,93,5362,508,5,4889,2540,11267,70,97,431,367,14,7380,12111,725,94,5793,875,93,1977,2537,4551,2520,526,16,21,38,21,4
"3184",9002,103574,697,92,4358,362,4,4928,1858,11993,77,96,298,243,13,7426,10860,774,93,4656,605,94,1413,1882,4057,2672,836,13,17,37,25,8
"3185",6703,100354,472,93,3363,284,4,4647,1844,12135,81,96,292,219,12,8129,8547,553,94,3655,503,94,1389,1759,2834,1866,699,16,21,33,22,8
"3186",12576,159520,832,93,4925,263,2,4535,3757,10722,196,95,524,252,7,6739,16333,1028,94,5449,515,97,2884,2800,4216,3909,2524,18,17,26,24,15
"3187",7426,112343,481,94,3305,161,2,4257,2441,10349,99,96,347,197,8,6903,9867,580,94,3652,358,96,1855,1887,2762,2331,1032,19,19,28,24,10
"3188",8262,113150,567,93,3844,256,3,5015,2562,11528,98,96,370,205,8,6654,10824,665,94,4214,461,96,1931,2136,3185,2389,1183,18,20,29,22,11
"3189",2840,71579,193,93,1696,119,4,4961,913,10791,28,97,142,93,10,6592,3753,221,94,1838,212,94,680,863,1372,739,99,18,23,37,20,3
"3190",4918,79375,321,93,2651,195,4,4301,1454,11709,44,97,204,141,10,7133,6372,365,94,2855,336,95,1099,1332,2212,1463,266,17,21,35,23,4
"3191",5018,113149,337,93,2185,107,2,4291,1476,11805,61,96,196,112,8,6333,6494,398,94,2381,219,97,1124,1198,1859,1583,730,17,18,29,24,11
"3192",10122,73633,628,94,5927,392,4,4292,3246,12439,121,96,464,345,11,6912,13368,749,94,6391,737,94,2368,2968,4989,2650,393,18,22,37,20,3
"3193",9668,118569,611,94,4488,217,2,3768,3373,11730,155,95,474,200,6,6658,13041,766,94,4962,417,97,2476,2650,3718,2849,1348,19,20,29,22,10
"3194",6663,76904,438,93,3760,238,4,4169,1995,12088,63,97,302,199,10,7173,8658,501,94,4062,437,95,1451,1884,3219,1759,345,17,22,37,20,4
"3195",16831,77433,1007,94,9259,564,3,4278,4797,11808,170,96,717,501,10,6638,21628,1177,95,9976,1065,95,3587,4659,7837,4767,778,17,22,36,22,4
"3196",11561,67877,607,95,6988,529,5,4421,3195,12170,98,97,477,465,15,7147,14756,705,95,7465,994,93,2356,3211,6111,2847,231,16,22,41,19,2
"3197",5601,74235,341,94,3344,213,4,5163,1620,12308,59,96,282,200,12,7372,7221,400,94,3626,413,94,1166,1608,2830,1401,216,16,22,39,19,3
"3198",7174,60471,324,95,4864,485,7,4522,2069,12440,57,97,300,393,19,7883,9243,381,96,5164,878,91,1495,2245,4054,1375,74,16,24,44,15,1
"3199",22667,62591,1060,95,15315,1577,7,4766,7574,12852,179,98,1118,1234,16,7503,30241,1239,96,16433,2811,91,5395,7785,12326,4340,395,18,26,41,14,1
"3200",1605,50579,45,97,1352,200,12,5204,534,13549,6,99,68,180,34,8654,2139,51,98,1420,380,82,367,595,1052,118,7,17,28,49,6,0
"3201",9183,56543,277,97,6741,614,7,4362,2239,12906,47,98,372,471,21,7435,11422,324,97,7113,1085,91,1610,2823,5650,1293,46,14,25,49,11,0
"3202",1242,72642,75,94,736,49,4,4532,352,11724,13,96,63,44,12,6795,1594,88,94,799,93,94,272,358,596,311,57,17,22,37,20,4
"3204",13889,83990,915,93,7356,436,3,4357,4435,11463,166,96,675,425,10,6639,18324,1081,94,8031,861,95,3388,3881,6026,4079,950,18,21,33,22,5
"3205",5800,109874,520,91,2592,191,3,4622,1494,10704,68,95,215,166,11,7522,7294,588,92,2807,357,95,1180,1258,2357,1904,595,16,17,32,26,8
"3206",5559,160071,392,93,2086,123,2,4898,1436,11149,58,96,225,96,7,7350,6995,450,94,2311,219,97,1087,1097,1901,1799,1111,16,16,27,26,16
"3207",9058,111962,808,91,3669,209,2,4768,1925,10867,105,95,287,174,9,8023,10983,913,92,3956,383,97,1473,1705,3396,3305,1104,13,16,31,30,10
"3211",606,74663,36,94,351,26,4,5333,183,-1712,7,96,26,17,9,6395,789,43,95,377,43,95,146,173,284,164,22,19,22,36,21,3
"3212",6933,66259,406,94,4263,379,5,4703,2074,12082,55,97,318,303,15,7239,9007,461,95,4581,682,92,1565,2009,3612,1703,118,17,22,40,19,1
"3213",1124,68081,61,95,734,79,7,4406,387,11631,14,96,68,62,16,6386,1511,75,95,802,141,91,291,396,538,247,39,19,26,36,16,3
"3214",6937,51461,248,96,5559,966,14,5065,2433,13556,36,99,355,754,31,7902,9370,284,97,5914,1720,82,1683,2919,3982,756,30,18,31,42,8,0
"3215",8367,62836,420,95,5654,603,7,5120,2746,12635,89,97,387,485,18,7818,11113,509,95,6041,1088,90,1976,2955,4370,1647,165,18,27,39,15,1
"3216",24061,66756,1334,94,15280,1550,6,4515,8839,11750,290,97,1154,1295,15,7327,32900,1624,95,16434,2845,91,6658,8174,12103,5290,675,20,25,37,16,2
"3217",2792,63650,147,95,1767,135,5,4451,676,11629,21,97,90,103,15,6570,3468,168,95,1857,238,93,525,725,1560,624,34,15,21,45,18,1
"3218",6054,68222,340,94,3749,400,7,4614,1764,11807,67,96,256,277,16,8034,7818,407,95,4005,677,91,1336,1835,3020,1455,172,17,23,39,19,2
"3219",7739,57486,404,95,5661,715,9,5046,2545,12955,63,98,390,555,22,7728,10284,467,95,6051,1270,88,1796,2939,4311,1139,99,17,29,42,11,1
"3220",8192,98864,541,93,4398,469,6,4809,2624,11469,100,96,397,347,13,7346,10816,641,94,4795,816,92,2004,2360,3651,2198,603,19,22,34,20,6
"3221",1826,84451,89,95,1053,44,2,4688,572,10209,22,96,83,45,8,7856,2398,111,95,1136,89,96,438,536,869,445,110,18,22,36,19,5
"3222",5803,62124,329,94,3999,343,6,4440,2239,12385,93,96,335,299,13,7392,8042,422,95,4334,642,92,1635,2227,3021,1043,116,20,28,38,13,1
"3223",2322,63043,133,94,1582,159,7,5025,1300,12172,50,96,169,144,11,7960,3622,183,95,1751,303,92,934,1025,1186,428,49,26,28,33,12,1
"3224",5833,60423,300,95,4029,314,5,4185,2031,12390,59,97,285,321,16,6967,7864,359,95,4314,635,92,1484,2060,3173,1054,93,19,26,40,13,1
"3225",1707,81489,114,93,987,63,4,3952,945,12105,29,97,107,71,8,6898,2652,143,95,1094,134,95,683,664,780,413,112,26,25,29,16,4
"3226",6378,68659,353,94,3921,310,5,4782,2400,12125,93,96,315,241,10,6459,8778,446,95,4236,551,94,1804,2170,3092,1511,201,21,25,35,17,2
"3227",2194,86252,148,93,1207,88,4,5000,845,11507,27,97,124,93,11,7242,3039,175,94,1331,181,94,636,713,946,591,153,21,23,31,19,5
"3228",8447,78457,483,94,4820,345,4,4402,2937,11692,102,97,417,322,11,6766,11384,585,95,5237,667,94,2226,2618,3874,2252,414,20,23,34,20,4
"3230",1087,67042,55,95,711,47,4,4234,537,11919,22,96,71,56,10,7170,1624,77,95,782,103,94,408,408,559,211,38,25,25,34,13,2
"3231",566,75408,35,94,354,32,6,5232,265,12135,13,95,44,25,9,8840,831,48,94,398,57,93,194,229,257,113,38,23,28,31,14,5
"3232",546,63534,31,94,392,18,3,4950,251,9943,10,96,36,23,9,5302,797,41,95,428,41,95,195,219,274,91,18,24,27,34,11,2
"3233",847,56093,30,96,655,50,6,4875,493,11873,21,96,74,63,13,6660,1340,51,96,729,113,92,355,427,428,113,17,26,32,32,8,1
"3234",69,59865,6,91,48,1,1,4007,26,8696,1,96,3,2,8,8796,95,7,93,51,3,97,24,20,38,0,0,25,21,40,0,0
"3235",163,58042,8,95,121,14,9,4085,76,6753,5,93,12,5,7,5890,239,13,95,133,19,92,60,62,87,0,0,25,26,36,0,0
"3236",97,57043,7,93,65,10,10,4030,53,15178,0,100,9,9,17,6121,150,7,95,74,19,87,37,46,50,0,0,25,31,33,0,0
"3237",56,42228,1,98,48,3,5,7994,64,9251,0,100,8,7,11,8443,120,1,99,56,10,92,54,34,28,0,0,45,28,23,0,0
"3238",84,48977,4,95,65,5,6,4608,68,6269,0,100,6,3,4,10463,152,4,97,71,8,95,57,46,40,0,0,38,30,26,0,0
"3239",164,54689,7,96,121,9,5,4647,75,4472,4,95,10,11,15,7934,239,11,95,131,20,92,63,51,101,0,0,26,21,42,0,0
"3240",952,69279,46,95,572,32,3,4988,361,11222,9,98,55,22,6,5060,1313,55,96,627,54,96,285,322,437,233,36,22,25,33,18,3
"3241",1021,57943,56,95,748,67,7,5217,453,10734,17,96,60,49,11,8130,1474,73,95,808,116,92,347,395,557,161,14,24,27,38,11,1
"3242",393,55404,12,97,299,29,7,4673,201,11935,9,96,46,22,11,6653,594,21,96,345,51,91,141,188,199,59,7,24,32,34,10,1
"3243",136,59763,4,97,91,8,6,3579,82,6352,1,99,5,12,15,9485,218,5,98,96,20,91,63,64,65,0,0,29,29,30,0,0
"3249",1495,58625,56,96,1066,81,5,4761,743,5911,22,97,74,66,9,7559,2238,78,97,1140,147,93,615,542,807,253,21,27,24,36,11,1
"3250",4893,56778,153,97,3672,377,8,4733,1729,11923,25,99,226,264,15,8047,6622,178,97,3898,641,90,1284,1800,2859,617,62,19,27,43,9,1
"3251",211,65811,14,93,152,19,9,4136,106,9430,3,97,21,12,11,5568,317,17,95,173,31,90,77,99,102,0,0,24,31,32,0,0
"3254",122,48954,2,98,104,12,10,5399,51,8969,0,100,6,4,8,3584,173,2,99,110,16,91,43,52,66,0,0,25,30,38,0,0
"3260",1848,57053,71,96,1343,117,6,4257,872,10251,16,98,108,107,12,6691,2720,87,97,1451,224,92,681,719,998,301,21,25,26,37,11,1
"3264",944,55156,25,97,704,64,7,4601,436,9946,14,97,70,56,13,7512,1380,39,97,774,120,91,306,410,516,0,0,22,30,37,0,0
"3265",1029,56920,49,95,748,54,5,5106,435,8981,14,97,67,50,11,8236,1464,63,96,815,104,93,340,374,591,149,10,23,26,40,10,1
"3266",1196,54983,41,97,869,55,5,4460,560,7767,11,98,70,46,8,7034,1756,52,97,939,101,94,436,497,626,190,7,25,28,36,11,0
"3267",114,51419,2,98,94,4,4,2875,68,6947,0,100,14,12,18,7068,182,2,99,108,16,91,58,58,52,0,0,32,32,29,0,0
"3268",1173,56525,47,96,869,66,6,4856,584,5445,13,98,92,53,9,7919,1757,60,97,961,119,93,481,498,593,164,21,27,28,34,9,1
"3269",288,68318,9,97,185,13,5,4806,145,5722,7,95,22,12,8,5793,433,16,96,207,25,94,112,118,128,63,12,26,27,30,15,3
"3270",96,63441,5,95,64,3,3,5360,45,9830,3,93,6,5,11,9068,141,8,94,70,8,94,33,36,55,0,0,23,26,39,0,0
"3271",85,67014,3,96,66,3,4,3912,34,1422,0,100,2,2,6,6396,119,3,97,68,5,96,31,34,44,0,0,26,29,37,0,0
"3272",552,54075,19,97,432,34,6,5028,286,12102,1,100,48,47,16,7755,838,20,98,480,81,90,203,254,309,65,7,24,30,37,8,1
"3273",52,70783,4,92,30,1,2,4826,27,6512,0,100,8,1,4,11174,79,4,95,38,2,97,17,18,31,0,0,22,23,39,0,0
"3274",102,64152,3,97,71,5,5,5275,57,4886,1,98,9,9,16,5096,159,4,97,80,14,91,44,45,49,0,0,28,28,31,0,0
"3275",204,59686,10,95,141,6,3,3056,72,10857,3,96,7,11,15,7889,276,13,95,148,17,94,53,64,118,0,0,19,23,43,0,0
"3276",206,56674,7,97,152,2,1,10090,85,10840,3,96,19,13,15,7276,291,10,97,171,15,95,66,80,112,0,0,23,27,38,0,0
"3277",894,60863,33,96,641,40,4,4029,295,11363,9,97,60,33,11,7812,1189,42,96,701,73,94,217,351,460,144,17,18,30,39,12,1
"3278",126,54349,4,97,97,9,7,4867,53,13790,1,98,14,9,17,9254,179,5,97,111,18,90,35,62,65,0,0,20,35,36,0,0
"3279",121,58929,7,94,92,7,6,4485,58,9087,1,98,5,5,9,8096,179,8,96,97,12,93,42,59,58,0,0,23,33,32,0,0
"3280",13736,59284,529,96,9921,1057,8,4529,5062,12203,78,98,719,842,17,7757,18798,607,97,10640,1899,90,3734,5217,7384,2206,257,20,28,39,12,1
"3281",747,62999,24,97,491,33,4,4109,264,11408,12,95,35,35,13,7379,1011,36,96,526,68,93,213,246,377,161,14,21,24,37,16,1
"3282",1181,58398,42,96,837,56,5,5009,420,10691,13,97,59,52,12,6922,1601,55,97,896,108,93,316,424,642,202,17,20,26,40,13,1
"3283",507,60575,19,96,356,21,4,3206,189,11306,1,99,31,24,13,7662,696,20,97,387,45,94,146,185,268,83,14,21,27,39,12,2
"3284",1410,67276,55,96,941,70,5,4652,640,11507,13,98,84,74,12,8356,2050,68,97,1025,144,93,484,522,730,275,39,24,25,36,13,2
"3285",506,61666,25,95,333,21,4,4314,216,12037,3,99,35,31,14,7324,722,28,96,368,52,93,159,212,237,108,6,22,29,33,15,1
"3286",237,61356,8,97,181,17,7,4916,118,9535,6,95,16,8,7,9592,355,14,96,197,25,93,93,92,132,0,0,26,26,37,0,0
"3287",182,57217,13,93,136,6,3,3226,89,6500,0,100,16,5,6,5758,271,13,95,152,11,96,72,75,98,20,6,27,28,36,7,2
"3289",326,58789,7,98,240,23,7,5506,135,11251,1,99,31,21,16,7508,461,8,98,271,44,90,91,140,176,0,0,20,30,38,0,0
"3292",58,54485,3,95,45,1,2,6767,43,11532,0,100,3,3,7,11138,101,3,97,48,4,96,34,32,25,0,0,34,32,25,0,0
"3293",138,52783,5,96,108,5,4,4791,73,10233,1,99,17,9,12,6634,211,6,97,125,14,93,51,63,79,0,0,24,30,37,0,0
"3294",386,55583,19,95,279,13,3,5377,223,8828,7,97,31,23,10,6682,609,26,96,310,36,94,176,175,188,65,5,29,29,31,11,1
"3300",4153,57131,126,97,3123,316,8,4517,1681,11861,22,99,228,241,14,7462,5834,148,97,3351,557,90,1186,1725,2307,548,68,20,30,40,9,1
"3301",475,56926,17,96,345,17,4,4357,222,3345,6,97,23,30,14,8394,697,23,97,368,47,93,190,166,264,0,0,27,24,38,0,0
"3302",174,60909,1,99,127,18,10,4304,76,9241,1,99,7,11,14,8916,250,2,99,134,29,88,63,61,97,0,0,25,24,39,0,0
"3303",149,58639,4,97,108,9,6,5422,60,3908,0,100,5,8,13,8040,209,4,98,113,17,92,51,56,72,0,0,24,27,34,0,0
"3304",1042,58635,38,96,712,76,7,5021,420,10157,8,98,60,57,14,7389,1462,46,97,772,133,91,328,394,523,208,9,22,27,36,14,1
"3305",5028,64910,363,93,3080,378,8,4728,1894,11742,72,96,245,343,18,7892,6922,435,94,3325,721,90,1431,1758,2357,1287,89,21,25,34,19,1
"3309",28,52432,2,93,22,2,7,9044,30,11119,1,97,4,6,20,7024,58,3,95,26,8,86,18,21,16,0,0,31,36,28,0,0
"3310",106,49208,5,95,87,8,8,3044,46,15587,1,98,7,9,20,5715,152,6,96,94,17,89,28,54,63,0,0,18,36,41,0,0
"3311",597,55686,18,97,444,34,6,3387,324,11834,1,100,47,44,14,7768,921,19,98,491,78,92,235,267,338,73,8,26,29,37,8,1
"3312",371,57110,14,96,272,18,5,5584,164,12030,5,97,24,22,13,7932,535,19,96,296,40,93,124,145,202,0,0,23,27,38,0,0
"3314",218,64998,8,96,165,14,6,5628,135,8114,1,99,22,15,11,6671,353,9,97,187,29,92,110,100,113,22,8,31,28,32,6,2
"3315",647,54864,8,99,506,51,8,5708,288,10446,2,99,53,40,14,9066,935,10,99,559,91,90,209,276,353,91,6,22,30,38,10,1
"3317",82,54759,4,95,65,6,7,4179,29,13114,0,100,7,2,7,8476,111,4,96,72,8,93,19,36,45,0,0,17,32,41,0,0
"3318",474,55006,16,97,363,31,7,4654,247,10163,7,97,28,32,13,5427,721,23,97,391,63,91,183,221,246,0,0,25,31,34,0,0
"3319",164,58402,10,94,120,13,8,3593,63,5305,3,95,11,2,3,2700,227,13,94,131,15,93,52,67,80,22,6,23,30,35,10,3
"3321",691,68910,41,94,415,24,3,4397,257,9312,9,96,36,27,11,6769,948,50,95,451,51,95,206,212,330,185,15,22,22,35,20,2
"3322",66,48078,1,98,54,10,15,5433,30,11265,0,100,3,8,27,6604,96,1,99,57,18,81,23,35,30,0,0,24,36,31,0,0
"3323",36,59364,2,94,23,0,0,NA,22,11135,0,100,5,3,14,6350,58,2,97,28,3,95,17,14,17,0,0,29,24,29,0,0
"3324",210,55953,12,94,159,13,6,6076,84,11149,2,98,12,15,18,7889,294,14,95,171,28,90,64,76,130,19,5,22,26,44,6,2
"3325",173,61206,3,98,127,10,6,5001,92,4037,1,99,13,8,9,8238,265,4,98,140,18,93,76,67,93,0,0,29,25,35,0,0
"3328",778,62509,64,92,497,29,4,4707,205,9543,6,97,20,25,12,6933,983,70,93,517,54,95,174,217,407,178,7,18,22,41,18,1
"3329",93,51625,4,96,74,5,5,4197,60,7522,2,97,5,3,5,3953,153,6,96,79,8,95,50,43,48,0,0,33,28,31,0,0
"3330",97,49977,1,99,82,7,7,5998,36,13592,2,94,10,4,11,7167,133,3,98,92,11,92,22,47,56,0,0,17,35,42,0,0
"3331",2581,65054,144,94,1627,96,4,4104,843,11459,33,96,132,95,11,7522,3424,177,95,1759,191,94,636,777,1391,574,46,19,23,41,17,1
"3332",436,63917,18,96,299,20,5,4642,154,10562,3,98,18,20,13,7965,590,21,96,317,40,93,123,142,236,80,9,21,24,40,14,2
"3333",333,66876,15,95,216,14,4,4410,153,8280,5,97,17,16,10,8118,486,20,96,233,30,94,126,109,184,59,8,26,22,38,12,2
"3334",226,62709,5,98,152,14,6,2791,93,9181,6,94,14,14,15,7854,319,11,97,166,28,91,71,82,118,0,0,22,26,37,0,0
"3335",2667,62758,94,96,1797,106,4,4564,577,12236,9,98,118,93,16,6862,3244,103,97,1915,199,94,419,679,1623,498,25,13,21,50,15,1
"3337",14478,57599,493,97,10338,1077,7,4717,4235,12735,79,98,717,904,21,7678,18713,572,97,11055,1981,89,3017,4763,8466,2368,99,16,25,45,13,1
"3338",8798,59306,309,96,5989,647,7,4557,2437,12653,48,98,375,529,22,7758,11235,357,97,6364,1176,90,1793,2705,5086,1586,65,16,24,45,14,1
"3340",9061,65916,424,95,5661,462,5,4688,2697,12007,76,97,408,386,14,7032,11758,500,96,6069,848,93,2013,2663,4782,2117,183,17,23,41,18,2
"3341",734,69439,36,95,442,23,3,4617,213,10694,4,98,41,18,8,8535,947,40,96,483,41,96,156,212,372,183,24,16,22,39,19,3
"3342",1376,64902,47,97,870,71,5,4849,522,11858,15,97,83,68,13,6660,1898,62,97,953,139,93,379,474,705,321,19,20,25,37,17,1
"3345",540,66942,22,96,312,25,5,5354,169,11433,5,97,35,17,10,8092,709,27,96,347,42,94,116,173,279,131,10,16,24,39,18,1
"3350",24699,66566,1270,95,16284,1846,7,5020,8284,12481,227,97,1234,1553,19,7700,32983,1497,95,17518,3399,90,6020,8526,12928,4861,648,18,26,39,15,2
"3351",3227,61485,116,96,2322,176,5,4770,1284,10797,36,97,187,213,17,7760,4511,152,97,2509,389,91,959,1256,1722,534,40,21,28,38,12,1
"3352",6662,63457,325,95,4475,308,5,4513,2403,11010,64,97,404,278,12,7558,9065,389,96,4879,586,94,1776,2359,3501,1288,141,20,26,39,14,2
"3355",4131,58235,163,96,3105,403,10,4796,1705,13114,38,98,239,358,21,8119,5836,201,97,3344,761,87,1175,1719,2308,563,71,20,29,40,10,1
"3356",5505,51917,192,97,4323,577,10,4767,1973,13537,26,99,340,509,26,7614,7478,218,97,4663,1086,85,1342,2296,3210,610,20,18,31,43,8,0
"3357",1594,71492,73,95,943,57,4,4455,617,11988,21,97,80,78,13,6718,2211,94,96,1023,135,94,465,512,781,407,46,21,23,35,18,2
"3360",262,53868,9,97,193,20,8,5761,108,9931,2,98,15,20,19,8024,370,11,97,208,40,89,81,110,144,0,0,22,30,39,0,0
"3361",208,55175,6,97,151,22,11,4177,137,7723,5,96,20,15,11,8666,345,11,97,171,37,89,96,103,114,0,0,28,30,33,0,0
"3363",1261,60759,51,96,936,73,6,4516,533,11924,15,97,81,91,17,8577,1794,66,96,1017,164,91,388,504,703,187,12,22,28,39,10,1
"3364",757,62552,35,95,522,43,6,4426,380,9115,10,97,67,42,11,7820,1137,45,96,589,85,93,279,302,393,143,20,25,27,35,13,2
"3370",543,52671,26,95,417,53,10,5630,286,12129,9,97,54,57,20,8823,829,35,96,471,110,87,203,276,267,0,0,24,33,32,0,0
"3371",307,52355,4,99,250,36,12,5037,173,11592,1,99,25,43,25,7979,480,5,99,275,79,84,126,153,166,0,0,26,32,35,0,0
"3373",759,54351,23,97,577,47,6,4646,415,8537,4,99,51,42,10,6986,1174,27,98,628,89,92,328,321,417,103,5,28,27,36,9,0
"3374",116,56122,3,97,82,5,4,5898,47,11891,0,100,7,8,17,7239,163,3,98,89,13,92,33,48,62,0,0,20,29,38,0,0
"3375",87,66319,2,98,57,5,6,5482,47,9343,1,98,7,6,13,7020,134,3,98,64,11,92,38,32,43,0,0,28,24,32,0,0
"3377",3401,55688,91,97,2478,261,8,4739,1378,11620,19,99,200,209,15,7999,4779,110,98,2678,470,90,1002,1333,1911,503,30,21,28,40,11,1
"3378",73,59264,4,95,54,4,5,5260,47,7165,2,96,8,4,9,6102,120,6,95,62,8,93,40,32,34,0,0,33,27,28,0,0
"3379",272,63644,11,96,184,18,7,5773,133,8219,3,98,21,17,13,8722,405,14,97,205,35,91,106,107,131,55,6,26,26,32,14,1
"3380",2352,56015,92,96,1753,167,7,5006,1021,11694,22,98,122,147,14,7673,3373,114,97,1875,314,91,760,925,1337,327,24,23,27,40,10,1
"3381",440,58196,15,97,314,20,5,4563,210,11570,10,95,32,26,12,6588,650,25,96,346,46,93,149,198,223,73,7,23,30,34,11,1
"3384",163,49885,1,99,130,23,14,5729,127,8668,5,96,20,15,12,8661,290,6,98,150,38,87,93,98,79,0,0,32,34,27,0,0
"3385",161,51118,8,95,126,15,9,6348,106,6163,5,95,13,20,19,7505,267,13,95,139,35,87,96,71,78,0,0,36,27,29,0,0
"3387",118,46924,2,98,97,9,8,4383,86,2086,6,93,17,7,8,7538,204,8,96,114,16,92,73,56,64,0,0,36,27,31,0,0
"3388",215,60221,7,97,148,16,7,5236,136,9014,2,99,25,24,18,8750,351,9,97,173,40,89,108,81,117,0,0,31,23,33,0,0
"3390",314,53702,13,96,219,17,5,3249,166,3214,2,99,28,20,12,7317,480,15,97,247,37,92,141,129,165,0,0,29,27,34,0,0
"3391",45,49515,0,100,37,4,9,1931,34,-9163,1,97,4,7,21,10078,79,1,99,41,11,86,30,26,17,0,0,38,33,22,0,0
"3392",173,49092,8,95,139,11,6,4988,134,1533,5,96,21,20,15,8115,307,13,96,160,31,90,107,96,82,0,0,35,31,27,0,0
"3393",1000,52692,34,97,778,55,6,5157,410,9214,13,97,46,56,14,8299,1410,47,97,824,111,92,292,466,530,112,10,21,33,38,8,1
"3395",159,52750,13,92,115,5,3,3512,79,-1812,2,97,8,13,16,8353,238,15,94,123,18,92,67,72,76,0,0,28,30,32,0,0
"3396",269,56363,15,94,195,16,6,4897,135,11082,6,96,15,20,15,9151,404,21,95,210,36,91,106,119,135,0,0,26,29,33,0,0
"3400",5883,57037,196,97,4359,403,7,4676,2297,11297,38,98,297,377,16,7135,8180,234,97,4656,780,90,1667,2300,3281,867,65,20,28,40,11,1
"3401",1784,55100,49,97,1325,69,4,5093,816,401,22,97,93,85,10,6639,2600,71,97,1418,154,94,712,688,923,262,15,27,26,36,10,1
"3407",190,56401,5,97,139,9,5,3767,89,6084,2,98,12,9,10,8325,279,7,97,151,18,94,76,64,112,0,0,27,23,40,0,0
"3409",386,50815,13,97,312,22,6,5503,219,-2751,8,96,33,22,10,7476,605,21,97,345,44,93,178,169,220,0,0,29,28,36,0,0
"3412",121,57385,5,96,88,10,8,4465,48,-537,1,98,2,4,8,7775,169,6,96,90,14,92,41,54,53,0,0,24,32,31,0,0
"3413",78,49388,0,100,59,4,5,4718,46,2576,1,98,5,7,15,5954,124,1,99,64,11,91,38,37,39,0,0,31,30,31,0,0
"3414",599,57066,30,95,430,37,6,6139,284,9104,5,98,46,53,19,6699,883,35,96,476,90,90,214,249,313,101,6,24,28,35,11,1
"3418",1055,54798,30,97,819,49,5,5434,598,3377,12,98,69,84,14,7980,1653,42,97,888,133,92,476,450,578,132,17,29,27,35,8,1
"3419",366,53320,17,95,280,12,3,3793,221,2378,2,99,30,21,10,7352,587,19,97,310,33,94,166,170,198,0,0,28,29,34,0,0
"3420",92,50391,4,96,65,6,7,2758,61,1625,1,98,10,9,15,9428,153,5,97,75,15,90,67,32,41,0,0,44,21,27,0,0
"3423",119,52904,3,97,95,11,9,4487,72,-3385,5,93,7,18,25,8071,191,8,96,102,29,85,63,47,66,0,0,33,25,35,0,0
"3424",268,52947,20,93,209,6,2,6377,140,6117,6,96,17,28,20,7111,408,26,94,226,34,92,118,114,142,0,0,29,28,35,0,0
"3427",1303,59864,61,95,914,72,6,4745,307,12309,7,98,60,34,11,6988,1610,68,96,974,106,93,214,385,793,200,18,13,24,49,12,1
"3428",291,68860,19,93,183,9,3,4719,104,11481,5,95,18,11,11,7199,395,24,94,201,20,95,73,98,152,66,6,18,25,38,17,2
"3429",16769,69209,841,95,10659,836,5,4378,4496,12107,123,97,654,638,14,6892,21265,964,95,11313,1474,93,3402,4903,8915,3731,314,16,23,42,18,1
"3430",135,77952,6,96,94,7,5,3619,38,8319,1,97,6,0,0,NA,173,7,96,100,7,96,27,49,64,0,0,16,28,37,0,0
"3431",1889,68406,123,93,1122,66,3,4272,559,11996,21,96,87,53,9,6531,2448,144,94,1209,119,95,422,549,922,511,44,17,22,38,21,2
"3432",86,79611,6,93,57,5,6,7177,24,9214,0,100,4,2,8,12893,110,6,95,61,7,94,20,31,40,13,6,18,28,36,12,5
"3433",117,73691,5,96,72,2,2,5038,28,8043,0,100,4,1,4,2216,145,5,97,76,3,98,22,33,56,0,0,15,23,39,0,0
"3434",2237,69044,132,94,1415,94,4,3670,657,12725,28,96,111,84,13,7135,2894,160,94,1526,178,94,477,703,1148,496,70,16,24,40,17,2
"3435",1186,66357,71,94,751,57,5,4601,440,10990,16,96,66,42,10,7502,1626,87,95,817,99,94,338,361,626,275,26,21,22,38,17,2
"3437",4825,81249,271,94,2582,154,3,4456,1503,11950,51,97,270,138,9,6192,6328,322,95,2852,292,95,1104,1379,2154,1453,238,17,22,34,23,4
"3438",977,79458,76,92,507,25,3,4689,304,11382,12,96,52,29,10,4789,1281,88,93,559,54,96,229,250,439,320,43,18,20,34,25,3
"3440",888,84652,56,94,468,31,3,4546,283,11485,9,97,44,15,5,8647,1171,65,94,512,46,96,219,252,374,273,53,19,22,32,23,5
"3441",641,101826,45,93,314,11,2,4675,205,8640,11,95,25,17,8,7582,846,56,93,339,28,97,153,170,251,196,76,18,20,30,23,9
"3442",3219,79443,212,93,1768,104,3,4801,1101,10680,44,96,153,100,9,8061,4320,256,94,1921,204,95,849,960,1425,915,171,20,22,33,21,4
"3444",3713,67605,165,96,2395,136,4,4300,1544,11461,46,97,212,174,11,7562,5257,211,96,2607,310,94,1137,1325,1872,813,110,22,25,36,15,2
"3446",398,59609,16,96,290,26,7,4346,156,11727,3,98,20,15,10,7224,554,19,97,310,41,93,116,160,217,54,7,21,29,39,10,1
"3447",181,55898,6,97,132,13,7,3621,77,11452,3,96,9,12,16,8034,258,9,97,141,25,90,60,70,100,0,0,23,27,39,0,0
"3448",340,61050,16,95,242,19,6,5554,178,11304,4,98,33,18,10,7348,518,20,96,275,37,93,127,149,169,67,6,25,29,33,13,1
"3450",2714,59370,113,96,1893,182,7,5205,1304,12713,24,98,180,195,15,8539,4018,137,97,2073,377,91,916,1174,1402,478,48,23,29,35,12,1
"3451",1682,58310,60,96,1212,80,5,4356,752,12071,30,96,111,116,15,8210,2434,90,96,1323,196,92,552,660,913,293,16,23,27,38,12,1
"3453",683,62165,27,96,469,27,4,4566,313,10584,4,99,30,33,11,6342,996,31,97,499,60,94,252,238,368,124,14,25,24,37,12,1
"3458",736,65920,41,94,471,37,5,5060,374,11029,9,98,55,42,11,7353,1110,50,95,526,79,93,269,310,362,150,19,24,28,33,14,2
"3460",1098,61185,56,95,797,65,6,4119,558,12246,19,97,92,90,16,6967,1656,75,95,889,155,91,402,493,550,180,31,24,30,33,11,2
"3461",1461,59542,78,95,1041,69,5,5613,729,11778,15,98,112,108,15,8138,2190,93,96,1153,177,92,546,614,758,231,41,25,28,35,11,2
"3462",415,55774,15,96,305,27,7,3965,205,12047,5,98,40,42,20,7669,620,20,97,345,69,89,144,187,218,0,0,23,30,35,0,0
"3463",815,58403,28,97,595,56,7,4798,480,10904,14,97,60,49,10,8764,1295,42,97,655,105,92,358,370,428,125,14,28,29,33,10,1
"3464",364,53289,14,96,281,30,8,3610,191,10224,1,99,35,37,19,7426,555,15,97,316,67,88,142,176,183,48,6,26,32,33,9,1
"3465",2907,51675,66,98,2350,290,10,4908,1432,11927,23,98,199,306,21,7957,4339,89,98,2549,596,86,998,1395,1657,260,29,23,32,38,6,1
"3467",390,52945,15,96,316,26,7,5814,200,10441,5,98,34,34,17,8147,590,20,97,350,60,90,140,200,206,0,0,24,34,35,0,0
"3468",89,46796,6,93,73,8,9,5914,56,7603,2,96,11,11,20,6935,145,8,94,84,19,87,45,48,44,0,0,31,33,30,0,0
"3469",78,56538,3,96,56,3,4,3120,59,12824,1,98,7,7,12,8828,137,4,97,63,10,93,42,45,40,0,0,31,33,29,0,0
"3472",346,50218,8,98,271,33,10,5580,249,9460,5,98,35,54,22,8121,595,13,98,306,87,85,176,201,184,0,0,30,34,31,0,0
"3475",86,46410,2,98,72,10,12,5999,62,1406,0,100,7,17,27,8365,148,2,99,79,27,82,47,48,44,0,0,32,32,30,0,0
"3477",242,48998,5,98,194,12,5,5417,158,7593,3,98,10,27,17,8141,400,8,98,204,39,90,143,107,125,0,0,36,27,31,0,0
"3478",904,52634,24,97,714,74,8,4503,455,11032,14,97,61,79,17,6986,1359,38,97,775,153,89,327,416,514,97,5,24,31,38,7,0
"3480",609,54422,18,97,462,44,7,5206,377,8368,8,98,59,75,20,9211,986,26,97,521,119,88,271,300,325,0,0,27,30,33,0,0
"3482",42,47054,6,86,35,4,10,5465,56,-8321,1,98,9,20,36,9392,98,7,93,44,24,76,44,29,22,0,0,45,30,22,0,0
"3483",313,58451,26,92,232,23,7,6368,221,3689,11,95,28,40,18,9867,534,37,93,260,63,88,176,150,157,0,0,33,28,29,0,0
"3485",88,46104,5,94,76,10,11,4868,78,8216,1,99,16,15,19,9251,166,6,96,92,25,85,56,61,43,0,0,34,37,26,0,0
"3487",33,59508,1,97,19,2,6,3770,17,7354,0,100,1,4,24,10062,50,1,98,20,6,88,16,8,16,0,0,32,16,32,0,0
"3488",49,56854,0,100,33,7,14,5237,21,7495,0,100,4,8,38,11987,70,0,100,37,15,79,16,21,21,0,0,23,30,30,0,0
"3490",446,55728,27,94,323,29,7,4755,261,9161,8,97,43,27,10,8603,707,35,95,366,56,92,182,204,255,0,0,26,29,36,0,0
"3491",44,62967,1,98,28,1,2,10927,22,7915,2,91,3,4,18,8792,66,3,95,31,5,92,19,15,23,0,0,29,23,35,0,0
"3494",230,49774,11,95,185,20,9,4992,96,10137,3,97,15,22,23,6123,326,14,96,200,42,87,69,104,130,0,0,21,32,40,0,0
"3496",2526,54611,139,94,1955,214,8,5231,958,7110,26,97,136,199,21,7414,3484,165,95,2091,413,88,731,980,1454,296,23,21,28,42,8,1
"3498",1884,60716,125,93,1301,138,7,4796,755,11907,38,95,114,131,17,7900,2639,163,94,1415,269,90,551,735,978,344,31,21,28,37,13,1
"3500",11368,57209,567,95,8480,1085,10,5029,4245,12651,92,98,600,872,21,7811,15613,659,96,9080,1957,87,3062,4452,6313,1621,165,20,29,40,10,1
"3501",1514,60865,91,94,1036,80,5,5105,537,11860,15,97,86,93,17,7345,2051,106,95,1122,173,92,396,520,841,267,27,19,25,41,13,1
"3505",1757,54854,94,95,1321,144,8,4812,777,11623,26,97,100,164,21,8033,2534,120,95,1421,308,88,573,718,997,230,16,23,28,39,9,1
"3507",58,72782,0,100,37,1,2,5944,27,-3836,0,100,3,3,11,12264,85,0,100,40,4,95,21,19,27,0,0,25,22,32,0,0
"3509",110,61981,3,97,76,9,8,4477,54,7605,0,100,7,5,9,9337,164,3,98,83,14,91,45,37,61,0,0,27,23,37,0,0
"3512",142,60328,7,95,101,3,2,5110,71,1637,4,94,12,5,7,6698,213,11,95,113,8,96,47,69,73,0,0,22,32,34,0,0
"3515",811,57615,30,96,589,34,4,3553,287,11421,9,97,41,46,16,6806,1098,39,96,630,80,93,220,273,485,0,0,20,25,44,0,0
"3516",248,56249,4,98,187,18,7,5813,140,6944,3,98,13,17,12,8649,388,7,98,200,35,91,119,93,133,0,0,31,24,34,0,0
"3517",404,53365,16,96,315,29,7,5477,245,9775,7,97,28,44,18,8866,649,23,96,343,73,89,194,189,221,0,0,30,29,34,0,0
"3518",333,55044,10,97,273,40,12,5658,273,9319,7,97,40,66,24,9192,606,17,97,313,106,83,195,190,182,32,7,32,31,30,5,1
"3521",262,57685,8,97,181,12,5,4391,80,12072,1,99,10,11,14,5939,342,9,97,191,23,93,64,81,149,0,0,19,24,44,0,0
"3522",106,58796,5,95,78,5,5,4565,73,8899,4,95,8,13,18,8209,179,9,95,86,18,90,59,51,52,0,0,33,28,29,0,0
"3523",1052,58500,50,95,761,77,7,4480,578,11990,14,98,73,81,14,8999,1630,64,96,834,158,90,413,477,557,166,17,25,29,34,10,1
"3525",434,52127,23,95,330,31,7,4387,310,4131,8,97,28,51,16,9722,744,31,96,358,82,89,256,194,233,0,0,34,26,31,0,0
"3527",211,49267,12,94,167,12,6,6043,201,1765,4,98,27,43,21,10137,412,16,96,194,55,87,162,110,118,0,0,39,27,29,0,0
"3529",44,50169,1,98,38,6,14,5522,45,2781,3,93,5,23,51,9365,89,4,96,43,29,67,40,15,31,0,0,45,17,35,0,0
"3530",43,60375,0,100,29,3,7,2733,31,10021,0,100,5,10,32,10665,74,0,100,34,13,82,25,17,24,0,0,34,23,32,0,0
"3531",75,50341,3,96,62,5,7,3289,37,-8745,1,97,4,11,30,9765,112,4,96,66,16,86,29,37,37,0,0,26,33,33,0,0
"3533",263,58337,9,97,194,13,5,6880,144,7711,3,98,14,28,19,8813,407,12,97,208,41,90,125,92,150,34,6,31,23,37,8,1
"3537",371,56634,15,96,268,20,5,5371,215,9263,5,98,27,19,9,6995,586,20,97,295,39,93,158,155,208,60,5,27,26,35,10,1
"3540",110,52067,2,98,87,5,5,5966,57,-4540,3,95,7,11,19,7415,167,5,97,94,16,90,45,49,61,0,0,27,29,37,0,0
"3542",51,45008,2,96,44,4,8,7116,57,2399,0,100,2,8,14,5572,108,2,98,46,12,89,52,26,28,0,0,48,24,26,0,0
"3544",88,48214,1,99,73,6,7,4229,49,2121,1,98,10,7,14,8968,137,2,99,83,13,91,36,49,46,0,0,26,36,34,0,0
"3546",183,55921,7,96,131,10,5,5980,87,5054,10,89,16,15,17,7776,270,17,94,147,25,91,66,77,92,0,0,24,29,34,0,0
"3549",1387,59137,49,96,1013,80,6,6304,607,10868,15,98,76,97,16,7977,1994,64,97,1089,177,91,477,544,729,229,15,24,27,37,11,1
"3550",16016,65142,768,95,10948,1431,9,5040,5869,12703,133,98,779,1192,20,7707,21885,901,96,11727,2623,88,4175,5921,8482,2948,359,19,27,39,13,2
"3551",13063,64880,656,95,8373,614,5,4149,4239,11112,127,97,588,487,11,6576,17302,783,95,8961,1101,94,3259,4017,6935,2825,266,19,23,40,16,2
"3555",7558,57410,291,96,5632,649,9,4525,2723,12552,57,98,372,488,18,7775,10281,348,97,6004,1137,89,1968,2870,4307,1068,68,19,28,42,10,1
"3556",4695,53268,161,97,3612,465,10,4492,1728,12747,35,98,242,387,22,8074,6423,196,97,3854,852,87,1224,1868,2750,551,30,19,29,43,9,0
"3557",305,60317,12,96,204,13,4,4240,118,6490,6,95,17,14,12,7107,423,18,96,221,27,94,96,99,162,0,0,23,23,38,0,0
"3558",328,55638,9,97,241,26,8,4751,174,6590,7,96,22,18,10,6245,502,16,97,263,44,91,132,146,166,0,0,26,29,33,0,0
"3559",171,60670,5,97,120,10,6,5885,118,-2046,2,98,11,11,9,5623,289,7,98,131,21,93,99,72,90,23,5,34,25,31,8,2
"3561",1635,58572,66,96,1151,91,6,4622,883,8967,29,97,109,100,11,7625,2518,95,96,1260,191,92,666,678,879,278,17,26,27,35,11,1
"3562",107,56864,5,95,83,4,4,4248,49,9590,0,100,7,5,10,4110,156,5,97,90,9,94,36,40,61,0,0,23,26,39,0,0
"3563",278,50246,8,97,232,21,8,3531,165,8039,1,99,25,25,15,8027,443,9,98,257,46,90,134,124,156,0,0,30,28,35,0,0
"3564",6933,58765,265,96,5013,466,7,4777,2503,11144,56,98,360,360,14,7375,9436,321,97,5373,826,91,1824,2644,3735,1133,100,19,28,40,12,1
"3566",196,54770,9,95,146,4,2,6582,93,9743,2,98,17,19,20,6314,289,11,96,163,23,92,63,96,99,0,0,22,33,34,0,0
"3567",254,53034,9,96,197,12,5,5190,138,3377,2,99,34,10,7,8255,392,11,97,231,22,94,95,119,142,0,0,24,30,36,0,0
"3568",1075,60509,40,96,796,54,5,4856,472,8919,10,98,61,67,14,7114,1547,50,97,857,121,92,362,465,548,150,22,23,30,35,10,1
"3570",271,56532,7,97,192,16,6,4455,133,11618,2,98,35,13,10,7321,404,9,98,227,29,93,89,112,166,0,0,22,28,41,0,0
"3571",99,51984,1,99,74,3,3,2587,97,7043,1,99,13,8,8,8188,196,2,99,87,11,94,78,52,55,0,0,40,27,28,0,0
"3572",98,65636,7,93,69,6,6,5657,51,9298,1,98,8,9,18,6627,149,8,95,77,15,90,41,37,55,0,0,28,25,37,0,0
"3573",134,50493,2,99,105,6,4,6084,67,2974,0,100,11,8,12,7833,201,2,99,116,14,93,53,61,70,0,0,26,30,35,0,0
"3575",280,51213,4,99,235,20,7,4394,168,6224,1,99,17,26,15,8628,448,5,99,252,46,90,136,124,161,0,0,30,28,36,0,0
"3579",1902,52695,64,97,1524,128,7,4858,1010,8635,12,99,126,131,13,8392,2912,76,97,1650,259,91,750,904,1032,211,15,26,31,35,7,1
"3580",369,49899,12,97,301,30,8,5048,192,11473,7,96,34,25,13,6361,561,19,97,335,55,90,141,180,201,0,0,25,32,36,0,0
"3581",62,53270,1,98,47,5,8,6032,44,7836,0,100,9,6,14,4928,106,1,99,56,11,90,33,35,28,0,0,31,33,26,0,0
"3583",66,49757,2,97,50,8,12,4063,27,8884,1,96,3,6,22,6214,93,3,97,53,14,85,23,28,33,0,0,25,30,35,0,0
"3584",396,53637,12,97,304,20,5,3741,178,10923,4,98,21,25,14,8184,574,16,97,325,45,92,137,148,233,0,0,24,26,41,0,0
"3585",5033,56928,202,96,3731,320,6,4712,1839,11075,39,98,268,279,15,7810,6872,241,96,3999,599,91,1337,1925,2819,731,60,19,28,41,11,1
"3586",168,51173,8,95,125,9,5,8696,73,7809,3,96,12,12,16,7626,241,11,95,137,21,91,62,77,83,0,0,26,32,34,0,0
"3588",130,46545,4,97,114,6,5,7740,55,11315,0,100,5,10,18,8915,185,4,98,119,16,91,43,64,69,0,0,23,35,37,0,0
"3589",120,66744,1,99,85,10,8,7365,48,7268,1,98,10,9,19,6805,168,2,99,95,19,89,33,52,58,15,10,20,31,35,9,6
"3590",128,53603,3,98,88,5,4,2375,57,11348,4,93,7,6,11,4809,185,7,96,95,11,94,47,50,66,0,0,25,27,36,0,0
"3591",74,52493,3,96,58,3,4,3234,23,9261,0,100,0,3,13,8317,97,3,97,58,6,94,20,29,38,0,0,21,30,39,0,0
"3594",223,47752,6,97,192,13,6,5009,122,12161,2,98,22,18,15,7640,345,8,98,214,31,91,94,98,132,0,0,27,28,38,0,0
"3595",202,46712,5,98,170,26,13,6614,111,13948,2,98,21,30,27,7851,313,7,98,191,56,82,73,113,110,0,0,23,36,35,0,0
"3596",49,69540,0,100,31,4,8,9461,20,11460,0,100,3,5,25,8462,69,0,100,34,9,87,17,20,24,0,0,25,29,35,0,0
"3597",176,57586,6,97,119,8,5,3856,53,7410,3,94,13,6,11,8372,229,9,96,132,14,94,39,73,82,0,0,17,32,36,0,0
"3599",48,69232,1,98,31,1,2,6104,13,11944,0,100,0,2,15,12966,61,1,98,31,3,95,10,16,21,0,0,16,26,34,0,0
"3607",42,75060,1,98,29,1,2,12585,12,14220,1,92,3,2,17,6833,54,2,96,32,3,94,6,13,24,0,0,11,24,44,0,0
"3608",939,58990,47,95,692,46,5,5383,409,11168,12,97,79,56,14,8296,1348,59,96,771,102,92,278,373,539,146,12,21,28,40,11,1
"3610",500,53145,12,98,387,40,8,4697,254,9711,5,98,47,36,14,7559,754,17,98,434,76,90,186,233,267,63,5,25,31,35,8,1
"3612",555,54762,22,96,417,47,8,5437,280,11500,6,98,34,46,16,8399,835,28,97,451,93,89,209,250,298,71,7,25,30,36,9,1
"3614",402,61208,25,94,268,17,4,6131,157,10025,2,99,26,24,15,7750,559,27,95,294,41,93,133,133,212,74,7,24,24,38,13,1
"3616",2125,58035,88,96,1499,155,7,4757,939,9168,16,98,136,116,12,7476,3064,104,97,1635,271,91,707,805,1170,362,20,23,26,38,12,1
"3617",69,48622,1,99,59,2,3,1695,28,1070,4,86,6,3,11,4341,97,5,95,65,5,95,20,31,42,0,0,21,32,43,0,0
"3618",265,49311,7,97,216,22,8,3450,142,8678,1,99,18,21,15,7105,407,8,98,234,43,89,117,112,157,0,0,29,28,39,0,0
"3620",3018,55319,103,97,2272,220,7,4483,1389,10885,24,98,203,216,16,7672,4407,127,97,2475,436,90,1018,1257,1678,430,24,23,29,38,10,1
"3621",827,50881,30,96,647,62,7,5216,462,8463,11,98,64,67,15,7096,1289,41,97,711,129,90,369,355,472,0,0,29,28,37,0,0
"3622",128,57838,12,91,83,5,4,5388,97,1505,1,99,5,7,7,8510,225,13,94,88,12,95,90,31,83,0,0,40,14,37,0,0
"3623",325,51552,13,96,256,23,7,5330,203,7810,2,99,31,32,16,8110,528,15,97,287,55,90,162,162,161,0,0,31,31,30,0,0
"3624",180,50142,5,97,143,13,7,8538,98,7235,0,100,16,22,22,5187,278,5,98,159,35,87,77,75,109,0,0,28,27,39,0,0
"3629",3549,53101,114,97,2762,337,9,4871,1390,12422,21,98,208,248,18,7891,4939,135,97,2970,585,88,976,1477,2056,407,23,20,30,42,8,0
"3630",11980,56714,364,97,9014,1085,9,4956,4683,12785,63,99,732,952,20,7790,16663,427,97,9746,2037,88,3309,4956,6604,1619,175,20,30,40,10,1
"3631",5004,63365,197,96,3399,244,5,4557,1820,10835,39,98,304,248,14,7162,6824,236,97,3703,492,93,1349,1798,2613,957,107,20,26,38,14,2
"3633",312,57438,6,98,220,18,6,6268,112,9542,5,96,23,12,11,8051,424,11,97,243,30,93,86,131,154,47,6,20,31,36,11,1
"3634",792,53787,34,96,604,45,6,3151,344,8871,8,98,53,50,15,7281,1136,42,96,657,95,92,267,312,458,91,8,24,27,40,8,1
"3635",214,51303,9,96,164,9,4,5773,103,2615,2,98,10,14,14,6752,317,11,97,174,23,93,80,91,118,0,0,25,29,37,0,0
"3636",1991,54528,67,97,1508,139,7,4318,921,9305,9,99,124,138,15,7799,2912,76,97,1632,277,90,660,841,1125,271,15,23,29,39,9,1
"3637",192,50259,7,96,158,10,5,4277,128,693,2,98,21,11,9,8550,320,9,97,179,21,93,99,96,106,0,0,31,30,33,0,0
"3638",743,58530,30,96,564,46,6,5297,403,9280,12,97,64,58,14,8898,1146,42,96,628,104,91,296,320,428,95,7,26,28,37,8,1
"3639",201,48912,1,100,169,22,11,4716,107,9623,0,100,22,17,16,9332,308,1,100,191,39,87,74,95,121,0,0,24,31,39,0,0
"3640",379,56784,11,97,278,20,5,5473,253,3295,5,98,38,33,13,8237,632,16,97,316,53,92,208,176,184,59,5,33,28,29,9,1
"3641",476,54889,14,97,343,32,7,5543,213,6238,6,97,26,23,11,7931,689,20,97,369,55,92,171,184,259,0,0,25,27,38,0,0
"3644",3423,58151,134,96,2422,230,7,4991,1345,10528,34,97,209,188,14,7401,4768,168,96,2631,418,91,967,1331,1851,582,37,20,28,39,12,1
"3646",224,54568,15,93,164,14,6,4024,128,10570,1,99,23,20,16,7736,352,16,95,187,34,90,97,99,116,0,0,28,28,33,0,0
"3649",161,53428,4,98,122,14,9,5909,93,5796,3,97,16,12,13,8088,254,7,97,138,26,90,66,83,79,0,0,26,33,31,0,0
"3658",2434,60621,81,97,1660,139,6,4868,843,12714,28,97,153,152,18,7528,3277,109,97,1813,291,91,582,870,1338,458,29,18,27,41,14,1
"3659",267,64553,13,95,180,6,2,4312,113,12114,4,96,20,11,10,7360,380,17,96,200,17,96,79,100,141,49,11,21,26,37,13,3
"3660",2750,56676,107,96,1986,213,8,5365,1044,12683,20,98,151,180,17,8034,3794,127,97,2137,393,90,746,1073,1521,425,29,20,28,40,11,1
"3662",386,73178,23,94,145,4,1,3183,92,9474,7,92,8,7,8,2845,478,30,94,153,11,98,83,50,212,0,0,17,10,44,0,0
"3663",68,61256,5,93,49,4,6,7726,25,10105,0,100,3,4,16,6664,93,5,95,52,8,91,21,29,30,0,0,23,31,32,0,0
"3664",435,63496,15,97,294,34,8,4358,179,10622,6,97,25,25,14,6374,614,21,97,319,59,90,134,165,217,88,10,22,27,35,14,2
"3665",128,56402,3,98,95,8,6,4066,67,12422,1,99,15,8,12,5481,195,4,98,110,16,92,42,73,61,0,0,22,37,31,0,0
"3666",1752,55639,75,96,1326,110,6,5270,937,9232,25,97,122,96,10,7150,2689,100,96,1448,206,92,691,764,967,244,23,26,28,36,9,1
"3669",449,63707,18,96,338,25,6,3853,287,10365,10,97,41,29,10,7897,736,28,96,379,54,93,207,227,228,66,8,28,31,31,9,1
"3670",216,57686,8,96,153,14,6,5432,119,10570,2,98,14,17,14,10275,335,10,97,167,31,91,96,87,120,0,0,29,26,36,0,0
"3672",3730,57269,163,96,2706,287,8,4966,1615,12691,33,98,204,255,16,7807,5345,196,96,2910,542,90,1159,1524,2034,584,44,22,29,38,11,1
"3673",652,59842,25,96,445,32,5,4851,421,9643,8,98,64,40,10,8362,1073,33,97,509,72,93,313,283,350,118,9,29,26,33,11,1
"3675",731,57463,29,96,519,45,6,4005,368,10982,7,98,61,40,11,8566,1099,36,97,580,85,92,261,299,412,118,9,24,27,37,11,1
"3677",7044,58003,245,97,5166,523,7,4647,2649,12544,43,98,337,493,19,7854,9693,288,97,5503,1016,90,1877,2586,4155,967,108,19,27,43,10,1
"3678",2715,62168,100,96,1856,112,4,4542,1206,10641,20,98,168,120,10,7936,3921,120,97,2024,232,94,906,1026,1442,493,54,23,26,37,13,1
"3682",248,58095,11,96,172,13,5,3653,92,8324,2,98,15,15,16,6995,340,13,96,187,28,92,66,89,142,0,0,19,26,42,0,0
"3683",754,57516,35,95,516,53,7,3973,266,10713,7,97,29,35,13,7749,1020,42,96,545,88,91,204,269,411,0,0,20,26,40,0,0
"3685",1181,58870,57,95,832,58,5,4683,478,12076,10,98,75,64,13,8261,1659,67,96,907,122,93,342,428,682,193,14,21,26,41,12,1
"3687",449,62842,17,96,299,26,6,4112,150,11719,6,96,25,22,15,7949,599,23,96,324,48,92,105,160,238,90,6,18,27,40,15,1
"3688",624,58732,21,97,431,26,4,3713,193,11813,6,97,34,15,8,6134,817,27,97,465,41,95,141,200,366,104,6,17,24,45,13,1
"3690",14280,59456,594,96,9971,1072,8,4883,4349,12878,110,97,667,835,19,7801,18629,704,96,10638,1907,90,3065,4631,8380,2386,167,16,25,45,13,1
"3691",4301,66488,201,95,2728,175,4,5333,1350,10489,47,97,197,161,12,7975,5651,248,96,2925,336,94,1020,1287,2334,920,90,18,23,41,16,2
"3694",96,54622,0,100,82,1,1,4639,9,15617,1,89,5,0,0,NA,105,1,99,87,1,99,4,17,78,0,0,4,16,74,0,0
"3695",213,57885,6,97,149,9,4,4097,103,10029,1,99,19,8,8,9042,316,7,98,168,17,95,80,79,111,0,0,25,25,35,0,0
"3697",199,60343,5,97,142,5,3,5394,117,12006,3,97,20,10,9,7503,316,8,97,162,15,95,91,95,91,34,5,29,30,29,11,2
"3698",331,60806,7,98,220,16,5,3728,185,11522,7,96,33,17,9,6334,516,14,97,253,33,94,125,150,174,62,5,24,29,34,12,1
"3699",416,54180,20,95,318,26,6,4796,231,12032,7,97,43,25,11,8566,647,27,96,361,51,92,166,211,211,54,5,26,33,33,8,1
"3700",598,55937,22,96,429,26,4,4613,232,10894,2,99,41,28,12,7150,830,24,97,470,54,93,177,227,332,0,0,21,27,40,0,0
"3701",420,55609,14,97,303,12,3,4947,209,10825,4,98,35,23,11,7167,629,18,97,338,35,94,157,185,221,0,0,25,29,35,0,0
"3705",116,57966,3,97,81,7,6,4774,52,11562,0,100,7,7,13,11396,168,3,98,88,14,92,38,52,57,0,0,23,31,34,0,0
"3707",693,55060,23,97,523,44,6,4580,288,11605,3,99,31,37,13,7871,981,26,97,554,81,92,226,301,347,95,12,23,31,35,10,1
"3709",124,56953,3,98,91,6,5,6512,78,11023,4,95,9,12,15,9701,202,7,97,100,18,91,60,60,60,0,0,30,30,30,0,0
"3711",188,57354,7,96,132,7,4,3988,106,10801,5,95,19,8,8,6717,294,12,96,151,15,95,77,88,94,0,0,26,30,32,0,0
"3712",142,65938,11,92,106,6,4,4957,59,12363,2,97,11,6,10,7911,201,13,94,117,12,94,43,46,87,0,0,21,23,43,0,0
"3713",306,50665,9,97,242,17,6,4044,157,12762,1,99,20,16,10,6701,463,10,98,262,33,93,111,164,147,0,0,24,35,32,0,0
"3714",1294,63076,41,97,932,60,5,4423,694,11471,12,98,96,80,12,8198,1988,53,97,1028,140,93,496,557,710,190,35,25,28,36,10,2
"3715",88,51281,3,97,75,4,5,5736,77,8435,0,100,14,6,8,9449,165,3,98,89,10,94,55,48,53,0,0,33,29,32,0,0
"3717",1026,60470,37,96,723,50,5,4317,539,11233,15,97,76,48,9,7002,1565,52,97,799,98,94,383,458,535,166,23,24,29,34,11,1
"3718",34,61581,1,97,21,0,0,NA,24,5193,3,88,3,2,8,2182,58,4,93,24,2,97,19,20,11,0,0,33,34,19,0,0
"3719",150,65592,5,97,110,12,8,3646,102,8352,4,96,19,13,13,5188,252,9,96,129,25,90,73,68,87,17,7,29,27,35,7,3
"3720",206,60199,11,95,156,10,5,6120,112,11507,5,96,20,10,9,6623,318,16,95,176,20,94,78,96,106,30,8,25,30,33,9,3
"3722",2014,58557,79,96,1465,94,5,5587,956,12357,25,97,156,88,9,7071,2970,104,96,1621,182,94,657,948,1027,303,35,22,32,35,10,1
"3723",922,60543,29,97,665,44,5,5965,579,10296,13,98,69,55,9,8410,1501,42,97,734,99,93,460,448,421,138,34,31,30,28,9,2
"3725",241,58296,14,94,180,11,5,3320,115,8336,3,97,20,15,13,6201,356,17,95,200,26,93,85,96,136,0,0,24,27,38,0,0
"3726",116,50472,4,97,94,9,8,6373,91,9215,0,100,15,12,13,10088,207,4,98,109,21,90,60,71,63,0,0,29,34,30,0,0
"3727",119,44662,6,95,105,5,4,4120,84,7185,4,95,13,12,14,8422,203,10,95,118,17,92,63,75,60,0,0,31,37,30,0,0
"3728",228,51185,6,97,176,24,11,5622,88,8047,2,98,7,19,22,7399,316,8,97,183,43,86,68,91,135,0,0,22,29,43,0,0
"3730",3185,57919,136,96,2298,187,6,5043,1443,12192,36,98,188,197,14,7949,4628,172,96,2486,384,92,1036,1320,1690,535,47,22,29,37,12,1
"3732",209,58950,8,96,153,8,4,4102,140,10674,6,96,15,11,8,8746,349,14,96,168,19,95,105,94,114,0,0,30,27,33,0,0
"3733",90,51233,6,93,71,4,4,4176,39,13949,4,90,8,5,13,5616,129,10,92,79,9,93,26,50,41,0,0,20,39,32,0,0
"3735",289,53313,10,97,209,10,3,6146,121,10904,2,98,24,20,17,7638,410,12,97,233,30,93,87,127,156,0,0,21,31,38,0,0
"3737",1751,56313,74,96,1287,101,6,4830,784,11340,14,98,108,107,14,7400,2535,88,97,1395,208,92,580,704,971,258,22,23,28,38,10,1
"3738",74,53978,1,99,56,4,5,5612,31,12582,0,100,7,5,16,5797,105,1,99,63,9,91,21,35,40,0,0,20,33,38,0,0
"3739",73,62623,0,100,53,5,7,3200,47,13402,0,100,8,8,17,8500,120,0,100,61,13,89,35,33,40,0,0,29,28,33,0,0
"3740",420,55389,14,97,315,20,5,3707,187,11973,6,97,28,23,12,6738,607,20,97,343,43,93,137,188,229,43,10,23,31,38,7,2
"3741",1264,57397,53,96,923,55,4,4749,633,11628,19,97,89,72,11,7438,1897,72,96,1012,127,93,473,576,645,184,19,25,30,34,10,1
"3744",163,54492,6,96,130,8,5,5278,82,11164,1,99,10,5,6,6746,245,7,97,140,13,95,64,83,79,14,5,26,34,32,6,2
"3746",126,57267,8,94,93,2,2,5476,67,11997,2,97,8,15,22,9205,193,10,95,101,17,91,52,52,71,0,0,27,27,37,0,0
"3747",1882,60580,86,95,1270,108,6,5147,811,11939,26,97,124,105,13,8057,2693,112,96,1394,213,92,590,719,1013,333,38,22,27,38,12,1
"3749",881,63036,43,95,585,39,4,4214,324,10724,6,98,45,44,14,7859,1205,49,96,630,83,93,240,322,450,180,13,20,27,37,15,1
"3750",3715,57630,129,97,2632,164,4,4481,970,11920,12,99,185,149,15,7349,4685,141,97,2817,313,93,736,1134,2183,615,17,16,24,47,13,0
"3751",88,67077,4,95,58,5,6,5621,37,12199,0,100,11,5,14,5121,125,4,97,69,10,92,25,35,50,0,0,20,28,40,0,0
"3752",10671,62080,430,96,7007,466,4,4659,2732,11896,62,98,494,384,14,6641,13403,492,96,7501,850,94,2061,3132,5901,2183,126,15,23,44,16,1
"3753",1015,63851,44,96,643,27,3,4699,230,12909,7,97,46,18,8,7856,1245,51,96,689,45,96,162,288,566,215,14,13,23,45,17,1
"3754",16352,63554,756,95,10491,695,4,4357,3945,12024,109,97,665,572,14,6942,20297,865,96,11156,1267,94,2924,4522,9037,3604,210,14,22,45,18,1
"3755",104,63400,7,93,66,4,4,5602,56,8730,0,100,7,8,14,5005,160,7,96,73,12,92,44,35,61,0,0,28,22,38,0,0
"3756",5201,62142,183,96,3431,243,5,4616,1315,12048,33,97,222,203,15,7328,6516,216,97,3653,446,93,966,1502,2929,1057,62,15,23,45,16,1
"3757",3702,64135,174,95,2373,133,4,4713,1196,12254,30,97,214,128,11,7607,4898,204,96,2587,261,95,854,1222,1975,781,66,17,25,40,16,1
"3758",1031,62979,43,96,663,34,3,4397,293,11867,3,99,46,45,15,7158,1324,46,97,709,79,94,227,290,564,232,11,17,22,43,18,1
"3759",498,78623,20,96,298,14,3,5489,160,11923,11,93,21,23,14,6372,658,31,95,319,37,94,124,149,244,110,31,19,23,37,17,5
"3760",213,71790,12,94,131,10,5,4462,79,13068,1,99,14,7,9,5431,292,13,96,145,17,94,59,58,114,54,7,20,20,39,18,2
"3761",516,65390,23,96,325,12,2,4606,192,11484,8,96,31,19,10,6554,708,31,96,356,31,96,150,194,228,125,11,21,27,32,18,2
"3762",65,68314,6,91,36,3,5,6587,26,11028,3,88,3,2,8,7075,91,9,90,39,5,95,20,19,32,0,0,22,21,35,0,0
"3763",709,58619,21,97,494,37,5,5301,251,11994,10,96,46,38,15,8087,960,31,97,540,75,92,181,258,387,129,5,19,27,40,13,1
"3764",3649,64981,153,96,2319,198,5,5022,1127,11587,29,97,180,156,14,7506,4776,182,96,2499,354,93,844,1143,1918,800,71,18,24,40,17,1
"3765",3189,67040,148,95,2042,121,4,3682,938,12642,23,98,139,99,11,6598,4127,171,96,2181,220,95,701,991,1678,676,81,17,24,41,16,2
"3766",573,68852,26,95,345,30,5,4585,203,13176,2,99,34,26,13,6158,776,28,96,379,56,93,143,192,282,145,14,18,25,36,19,2
"3767",507,70063,21,96,288,18,4,3730,211,13179,5,98,41,22,10,7590,718,26,96,329,40,94,149,182,227,145,15,21,25,32,20,2
"3770",1502,80757,75,95,964,37,2,4392,482,11607,14,97,74,44,9,7046,1984,89,96,1038,81,96,366,482,769,312,55,18,24,39,16,3
"3775",1769,72413,96,95,1115,62,4,5019,637,10589,21,97,85,46,7,6808,2406,117,95,1200,108,96,481,556,936,364,69,20,23,39,15,3
"3777",4329,60274,169,96,3044,229,5,4345,1562,12412,42,97,240,192,12,7431,5891,211,96,3284,421,93,1140,1652,2285,736,78,19,28,39,12,1
"3778",71,48304,0,100,58,1,1,2110,55,10195,0,100,6,5,9,6114,126,0,100,64,6,95,45,36,38,0,0,36,29,30,0,0
"3779",130,50619,2,98,110,4,3,4322,115,4994,2,98,19,11,10,6995,245,4,98,129,15,94,85,77,67,0,0,35,31,27,0,0
"3781",1913,65521,78,96,1325,91,5,4294,529,11678,9,98,82,79,15,7340,2442,87,96,1407,170,93,392,599,1076,347,28,16,25,44,14,1
"3782",3603,69897,169,95,2236,124,3,3951,1210,11902,28,98,199,122,10,6438,4813,197,96,2435,246,95,908,1209,1737,847,112,19,25,36,18,2
"3783",998,63578,50,95,638,48,5,4624,315,12693,4,99,55,40,13,5829,1313,54,96,693,88,93,240,324,515,218,16,18,25,39,17,1
"3786",696,76733,33,95,379,29,4,3721,240,12168,12,95,33,18,8,7064,936,45,95,412,47,95,174,219,311,198,34,19,23,33,21,4
"3787",507,69992,28,94,307,25,5,4991,167,12108,7,96,27,12,7,8440,674,35,95,334,37,95,126,177,221,131,19,19,26,33,19,3
"3788",825,91121,54,93,468,25,3,3503,303,11557,14,95,37,33,11,7128,1128,68,94,505,58,95,239,250,358,238,43,21,22,32,21,4
"3789",120,86404,8,93,61,6,5,2380,47,11600,1,98,3,6,13,7599,167,9,95,64,12,93,34,36,53,29,15,20,22,32,17,9
"3791",696,71029,37,95,415,22,3,3763,252,12558,3,99,37,26,10,7250,948,40,96,452,48,95,191,231,324,177,25,20,24,34,19,3
"3792",487,74854,22,95,269,15,3,3716,189,11648,2,99,31,19,10,6819,676,24,96,300,34,95,139,155,225,133,24,21,23,33,20,4
"3793",1501,64315,67,96,1019,70,5,4198,603,12475,5,99,86,63,10,7020,2104,72,97,1105,133,94,443,550,787,297,27,21,26,37,14,1
"3795",665,65313,33,95,418,24,4,4776,236,11271,8,97,42,26,11,6580,901,41,95,460,50,94,182,227,336,137,19,20,25,37,15,2
"3796",4299,62627,158,96,2811,187,4,4449,1368,11898,42,97,204,150,11,6701,5667,200,96,3015,337,94,1034,1378,2257,937,61,18,24,40,17,1
"3797",1340,56313,32,98,940,71,5,4931,498,11708,7,99,84,65,13,8758,1838,39,98,1024,136,93,368,509,728,224,9,20,28,40,12,0
"3799",2181,54292,74,97,1668,182,8,4836,806,12834,14,98,144,168,21,7840,2987,88,97,1812,350,88,555,897,1261,256,18,19,30,42,9,1
"3800",41,74857,1,98,24,6,15,8264,59,8201,1,98,4,17,29,6841,100,2,98,28,23,77,54,17,14,0,0,54,17,14,0,0
"3802",10310,58712,344,97,7287,572,6,4744,3317,11967,61,98,590,635,19,6828,13627,405,97,7877,1207,91,2517,3483,5777,1761,89,18,26,42,13,1
"3803",4139,55436,126,97,3119,290,7,4437,1408,12395,23,98,270,306,22,7219,5547,149,97,3389,596,89,1041,1506,2425,546,29,19,27,44,10,1
"3804",3987,75681,155,96,2357,86,2,4035,1196,11512,30,97,216,107,9,6179,5183,185,96,2573,193,96,916,1214,1886,976,191,18,23,36,19,4
"3805",24116,59999,851,96,16819,1330,6,4356,6883,11729,104,98,1168,1201,17,6866,30999,955,97,17987,2531,92,5221,7699,13573,4242,264,17,25,44,14,1
"3806",21459,71518,994,95,12889,801,4,4315,6430,11873,157,98,1004,718,11,6740,27889,1151,96,13893,1519,95,4873,6222,10756,5365,673,17,22,39,19,2
"3807",3502,73137,178,95,2041,125,4,4272,957,9907,34,96,156,92,10,6746,4459,212,95,2197,217,95,709,1077,1605,943,125,16,24,36,21,3
"3808",1463,81836,81,94,804,41,3,4975,436,11558,23,95,87,31,7,6463,1899,104,95,891,72,96,312,455,651,396,85,16,24,34,21,4
"3809",3488,63050,154,96,2261,150,4,4602,775,12244,20,97,127,117,15,7275,4263,174,96,2388,267,94,590,891,2037,707,38,14,21,48,17,1
"3810",19707,58487,715,96,13879,1248,6,4530,5456,12484,96,98,838,967,18,7314,25163,811,97,14717,2215,91,3998,6294,11420,3277,174,16,25,45,13,1
"3812",1124,63558,58,95,739,45,4,4219,389,12004,15,96,68,33,8,7186,1513,73,95,807,78,95,286,396,558,247,26,19,26,37,16,2
"3813",382,151191,19,95,256,18,5,3677,131,11742,5,96,25,13,10,8299,513,24,95,281,31,94,93,139,193,0,0,18,27,38,0,0
"3814",948,61505,35,96,641,46,5,4721,356,11208,9,97,60,37,10,6698,1304,44,97,701,83,94,259,340,493,198,14,20,26,38,15,1
"3815",1231,61919,48,96,811,41,3,4002,437,11496,8,98,74,35,8,6551,1668,56,97,885,76,95,314,476,598,265,15,19,29,36,16,1
"3816",1064,56002,28,97,784,65,6,5269,405,11177,11,97,59,74,18,7536,1469,39,97,843,139,91,301,401,606,148,13,20,27,41,10,1
"3818",5325,59123,168,97,3735,306,6,4620,2147,11005,49,98,280,288,13,7566,7472,217,97,4015,594,92,1615,1988,2874,926,69,22,27,38,12,1
"3820",6722,64978,302,96,4430,348,5,4600,2672,11773,76,97,376,338,13,7804,9394,378,96,4806,686,93,1980,2473,3393,1363,185,21,26,36,15,2
"3821",1155,64105,45,96,777,41,4,4555,521,9161,5,99,75,55,11,6441,1676,50,97,852,96,94,417,427,587,210,35,25,25,35,13,2
"3822",429,59873,26,94,295,19,4,5247,131,9658,3,98,19,19,15,5714,560,29,95,314,38,93,108,152,209,0,0,19,27,37,0,0
"3823",765,61668,34,96,524,35,5,3864,292,9110,6,98,44,34,12,7669,1057,40,96,568,69,93,219,283,409,132,14,21,27,39,12,1
"3824",2009,66557,96,95,1285,110,5,5248,763,10949,9,99,103,101,13,6639,2772,105,96,1388,211,92,564,701,986,466,55,20,25,36,17,2
"3825",7117,64329,470,93,4730,635,9,5205,2651,12598,83,97,403,519,20,8408,9768,553,94,5133,1154,88,1883,2713,3454,1548,170,19,28,35,16,2
"3831",679,62985,23,97,459,18,3,4065,294,11209,11,96,49,17,6,6739,973,34,97,508,35,96,213,268,347,127,18,22,28,36,13,2
"3832",81,58191,5,94,56,4,5,4114,43,13646,3,93,9,4,9,9031,124,8,94,65,8,94,31,30,42,0,0,25,24,34,0,0
"3833",88,55603,4,95,64,4,5,4216,66,13896,0,100,13,12,18,7406,154,4,97,77,16,90,39,57,43,0,0,25,37,28,0,0
"3835",229,63844,7,97,163,19,8,5179,112,10797,1,99,18,13,12,9622,341,8,98,181,32,91,85,96,113,39,8,25,28,33,11,2
"3840",5567,65264,295,95,3660,537,10,5434,2104,12539,52,98,273,446,21,8562,7671,347,95,3933,983,87,1514,2045,2783,1185,144,20,27,36,15,2
"3842",1636,62988,97,94,1106,162,10,5373,560,13038,17,97,75,148,26,8376,2196,114,95,1181,310,86,409,614,800,323,50,19,28,36,15,2
"3844",12446,72709,760,94,7331,746,6,4978,3723,12211,124,97,530,543,15,8069,16169,884,95,7861,1289,92,2742,3716,5900,3327,484,17,23,36,21,3
"3847",822,62557,41,95,535,47,6,5228,320,9730,10,97,49,50,16,7808,1142,51,96,584,97,92,232,294,405,199,12,20,26,35,17,1
"3850",5920,71382,320,95,3732,377,6,4769,2190,12697,89,96,334,341,16,7572,8110,409,95,4066,718,91,1545,2161,2790,1318,296,19,27,34,16,4
"3851",1602,68666,83,95,1008,103,6,5086,813,10403,23,97,117,104,13,7596,2415,106,96,1125,207,91,612,655,721,356,71,25,27,30,15,3
"3854",666,79371,34,95,357,19,3,4158,200,9401,10,95,33,19,10,10179,866,44,95,390,38,96,148,197,277,210,34,17,23,32,24,4
"3856",426,72350,27,94,237,15,4,4300,150,11649,3,98,21,18,12,6465,576,30,95,258,33,94,115,135,190,116,20,20,23,33,20,3
"3857",155,65062,2,99,103,9,6,2621,66,6309,0,100,9,7,11,10130,221,2,99,112,16,93,53,52,82,0,0,24,24,37,0,0
"3858",1144,61105,45,96,806,64,6,4459,483,8392,13,97,69,69,14,8329,1627,58,96,875,133,92,359,450,591,200,27,22,28,36,12,2
"3859",291,61904,8,97,203,16,5,5685,164,6633,7,96,20,17,10,6927,455,15,97,223,33,93,134,118,140,57,6,29,26,31,13,1
"3860",2899,62023,119,96,1995,177,6,4841,1149,12768,34,97,183,129,11,7290,4048,153,96,2178,306,92,830,1147,1457,540,74,21,28,36,13,2
"3862",1246,64218,53,96,858,73,6,4402,533,9961,11,98,71,61,11,8593,1779,64,96,929,134,92,412,455,642,221,49,23,26,36,12,3
"3864",76,47862,4,95,66,7,9,5958,36,10278,1,97,4,3,8,6248,112,5,96,70,10,91,29,41,36,0,0,26,37,32,0,0
"3865",206,55740,6,97,150,7,3,3975,92,11747,1,99,13,11,12,7127,298,7,98,163,18,94,71,74,120,0,0,24,25,40,0,0
"3869",776,74424,47,94,439,39,5,5698,267,11168,12,96,40,32,12,6375,1043,59,94,479,71,93,203,265,327,218,30,19,25,31,21,3
"3870",461,64154,31,93,291,35,8,5169,237,11688,12,95,32,36,15,9062,698,43,94,323,71,90,175,188,217,109,9,25,27,31,16,1
"3871",1067,61484,54,95,742,68,6,4356,514,10400,20,96,80,73,14,8166,1581,74,95,822,141,91,387,437,523,211,23,24,28,33,13,1
"3873",132,64425,3,98,80,6,5,6195,64,10750,0,100,6,7,11,10386,196,3,98,86,13,93,49,55,54,0,0,25,28,28,0,0
"3874",231,199424,13,94,148,15,6,4944,112,11401,2,98,17,23,21,7790,343,15,96,165,38,89,88,84,114,49,8,26,24,33,14,2
"3875",7129,57352,216,97,5378,509,7,5031,2862,11920,53,98,402,423,15,7510,9991,269,97,5780,932,91,2052,2876,3979,977,107,21,29,40,10,1
"3878",383,61194,13,97,272,21,5,3231,207,12799,10,95,26,37,18,8823,590,23,96,298,58,90,152,165,192,72,9,26,28,33,12,2
"3880",1179,59674,37,97,861,77,7,4233,793,12927,13,98,102,91,11,7219,1972,50,97,963,168,91,559,580,613,184,36,28,29,31,9,2
"3882",405,58127,16,96,284,26,6,4137,206,12953,3,99,31,39,19,6856,611,19,97,315,65,89,150,168,225,0,0,25,27,37,0,0
"3885",688,51984,28,96,543,37,5,4459,342,11181,3,99,50,64,19,7879,1030,31,97,593,101,90,257,302,389,0,0,25,29,38,0,0
"3886",125,56499,4,97,92,12,10,7177,65,13152,2,97,10,10,15,7632,190,6,97,102,22,88,46,63,57,0,0,24,33,30,0,0
"3887",101,47059,3,97,86,9,9,5886,66,10062,0,100,11,10,15,7540,167,3,98,97,19,89,48,60,48,0,0,29,36,29,0,0
"3888",1116,56689,36,97,812,97,9,5074,541,12390,14,97,81,109,20,8604,1657,50,97,893,206,88,394,532,525,193,13,24,32,32,12,1
"3889",32,44015,0,100,29,4,12,6599,50,7156,0,100,5,8,16,9328,82,0,100,34,12,85,39,24,18,0,0,48,29,22,0,0
"3890",106,59750,3,97,69,14,13,6211,60,10524,4,93,10,13,22,9277,166,7,96,79,27,84,46,46,48,0,0,28,28,29,0,0
"3891",36,88960,1,97,25,5,14,5334,29,13298,0,100,7,2,7,5878,65,1,98,32,7,89,19,19,18,0,0,29,29,28,0,0
"3892",355,56742,5,99,257,29,8,4447,224,12737,0,100,24,30,13,8033,579,5,99,281,59,90,166,178,170,57,8,29,31,29,10,1
"3895",65,55167,0,100,48,3,5,8067,54,12266,0,100,14,4,7,8310,119,0,100,62,7,94,38,39,34,0,0,32,33,29,0,0
"3896",165,56263,5,97,119,16,10,5766,63,17105,0,100,14,9,14,8200,228,5,98,133,25,89,38,72,83,0,0,17,32,36,0,0
"3898",266,50716,17,94,199,15,6,4021,139,9239,5,96,16,19,14,8842,405,22,95,215,34,92,106,129,135,0,0,26,32,33,0,0
"3900",72,58288,3,96,49,2,3,2012,38,11186,1,97,8,4,11,6267,110,4,96,57,6,95,28,32,38,0,0,25,29,35,0,0
"3902",147,60732,7,95,104,11,7,6241,80,10941,4,95,4,11,14,8198,227,11,95,108,22,90,62,58,85,16,6,27,26,37,7,3
"3903",279,61308,9,97,204,12,4,6813,133,13862,1,99,23,17,13,6114,412,10,98,227,29,93,91,126,145,44,6,22,31,35,11,1
"3904",521,60833,24,95,380,34,7,4252,319,13002,10,97,51,39,12,6405,840,34,96,431,73,91,220,253,275,78,14,26,30,33,9,2
"3909",2627,55718,76,97,2038,220,8,5226,1347,12469,31,98,178,184,14,7918,3974,107,97,2216,404,90,974,1293,1307,342,58,25,33,33,9,1
"3910",10851,62934,459,96,7179,511,5,4294,2915,12277,64,98,463,386,13,6820,13766,523,96,7642,897,93,2169,3250,5951,2217,179,16,24,43,16,1
"3911",1503,67203,53,96,1010,76,5,4136,487,12692,13,97,94,76,16,7768,1990,66,97,1104,152,92,343,544,773,285,45,17,27,39,14,2
"3912",7001,62619,337,95,4661,334,5,4191,2154,12495,58,97,362,248,12,6921,9155,395,96,5023,582,94,1572,2327,3744,1379,133,17,25,41,15,1
"3913",1662,67581,79,95,1070,76,5,4796,516,12956,13,97,89,58,11,6792,2178,92,96,1159,134,94,368,572,830,358,50,17,26,38,16,2
"3915",3426,60264,143,96,2452,277,8,5035,1244,13557,31,98,198,227,18,7442,4670,174,96,2650,504,89,858,1293,1919,545,55,18,28,41,12,1
"3916",453,94665,24,95,253,11,2,5750,176,11617,10,94,28,17,10,6188,629,34,95,281,28,96,126,158,181,115,49,20,25,29,18,8
"3918",1736,62069,79,95,1155,63,4,4037,536,12612,17,97,97,57,11,6899,2272,96,96,1252,120,95,386,619,886,353,28,17,27,39,16,1
"3919",1310,54865,47,96,974,106,8,4737,399,13125,9,98,62,88,22,7465,1709,56,97,1036,194,89,283,488,729,204,5,17,29,43,12,0
"3920",368,55129,11,97,278,19,5,4317,65,11346,2,97,10,8,12,5059,433,13,97,288,27,94,54,98,236,0,0,12,23,55,0,0
"3921",33,65776,3,91,21,3,9,6367,39,15285,1,97,5,5,13,12913,72,4,94,26,8,89,26,23,16,0,0,36,32,22,0,0
"3922",2729,56510,125,95,2084,199,7,4956,1384,12977,51,96,212,186,13,7640,4113,176,96,2296,385,91,950,1318,1412,378,55,23,32,34,9,1
"3923",232,63848,13,94,171,11,5,4663,115,14092,7,94,19,10,9,7278,347,20,94,190,21,94,76,113,118,31,9,22,33,34,9,3
"3925",1374,59569,65,95,988,86,6,4974,622,12574,21,97,92,93,15,7514,1996,86,96,1080,179,91,445,583,707,237,24,22,29,35,12,1
"3926",1466,80316,71,95,868,40,3,3425,600,11735,20,97,94,49,8,7684,2066,91,96,962,89,96,436,525,656,361,88,21,25,32,17,4
"3927",683,77070,37,95,400,14,2,5037,328,11800,8,98,44,28,9,7108,1011,45,96,444,42,96,243,238,311,186,33,24,24,31,18,3
"3928",216,146873,12,94,114,2,1,2622,84,9463,1,99,10,8,10,6995,300,13,96,124,10,97,72,68,84,56,20,24,23,28,19,7
"3929",424,130924,24,94,217,12,3,4790,205,13370,9,96,34,16,8,7561,629,33,95,251,28,96,149,145,166,107,62,24,23,26,17,10
"3930",8358,100323,489,94,4015,220,3,4080,2959,11930,118,96,420,196,7,6672,11317,607,95,4435,416,96,2200,2342,3396,2547,832,19,21,30,23,7
"3931",9903,72213,521,95,6247,462,5,4337,3893,13355,99,97,607,369,9,7005,13796,620,96,6854,831,94,2696,3685,4886,2176,353,20,27,35,16,3
"3933",531,81551,32,94,280,5,1,2113,217,9069,8,96,41,12,6,6819,748,40,95,321,17,98,163,175,242,125,43,22,23,32,17,6
"3934",8206,79543,411,95,4671,266,3,4283,2958,12524,104,96,465,275,9,6717,11164,515,95,5136,541,95,2127,2755,3641,2178,463,19,25,33,20,4
"3936",4464,67709,220,95,2941,254,6,4381,1952,12794,50,97,267,204,10,6917,6416,270,96,3208,458,93,1381,1740,2251,909,135,22,27,35,14,2
"3937",771,97119,56,93,445,25,3,5254,293,11557,10,97,60,20,7,6434,1064,66,94,505,45,96,210,266,347,184,57,20,25,33,17,5
"3938",1251,65401,58,95,832,61,5,3664,567,11846,21,96,70,58,10,6688,1818,79,96,902,119,93,418,480,636,253,31,23,26,35,14,2
"3939",5311,58361,187,96,3887,363,7,4440,2295,12660,42,98,327,316,14,7235,7606,229,97,4214,679,91,1600,2302,2823,786,95,21,30,37,10,1
"3940",1382,55457,40,97,1079,105,8,4755,741,13555,15,98,89,105,14,7485,2123,55,97,1168,210,90,492,643,795,175,18,23,30,37,8,1
"3941",4716,59513,195,96,3469,336,7,4529,2062,13379,36,98,366,309,15,7233,6778,231,97,3835,645,90,1391,2161,2415,716,95,21,32,36,11,1
"3942",916,75238,53,94,574,39,4,5060,500,13049,14,97,72,26,5,7505,1416,67,95,646,65,95,342,385,450,185,54,24,27,32,13,4
"3943",697,166627,38,95,372,23,3,5464,413,12351,15,96,55,23,6,7411,1110,53,95,427,46,96,300,267,287,169,87,27,24,26,15,8
"3944",322,227706,21,93,119,4,1,5829,123,9042,9,93,13,2,2,13944,445,30,93,132,6,99,93,83,106,96,67,21,19,24,22,15
"3945",386,59865,20,95,285,17,4,4469,202,10078,9,96,34,23,11,7339,588,29,95,319,40,93,153,169,205,55,6,26,29,35,9,1
"3946",98,57731,2,98,75,5,5,3942,66,6855,1,98,14,7,11,7822,164,3,98,89,12,93,46,48,57,0,0,28,29,35,0,0
"3950",1727,59790,59,97,1242,92,5,5127,767,11526,15,98,98,114,15,7470,2494,74,97,1340,206,92,568,704,901,293,28,23,28,36,12,1
"3951",397,58691,17,96,283,16,4,7239,198,8538,3,98,32,22,11,6939,595,20,97,315,38,94,149,174,202,60,10,25,29,34,10,2
"3953",3107,60320,108,97,2131,177,6,4540,1373,11235,31,98,193,135,10,7492,4480,139,97,2324,312,93,985,1280,1569,593,53,22,29,35,13,1
"3954",163,66909,5,97,109,5,3,3483,82,11709,3,96,11,7,9,8332,245,8,97,120,12,95,62,71,78,25,9,25,29,32,10,4
"3956",877,55698,42,95,660,64,7,5186,483,9893,12,98,68,58,12,8108,1360,54,96,728,122,91,365,424,431,127,13,27,31,32,9,1
"3957",130,54377,5,96,101,6,5,4310,58,7688,0,100,11,6,10,8380,188,5,97,112,12,94,37,62,68,0,0,20,33,36,0,0
"3958",100,52375,4,96,76,3,3,7436,70,7341,0,100,11,16,23,6899,170,4,98,87,19,89,59,44,55,0,0,35,26,32,0,0
"3959",432,58060,8,98,318,16,4,5460,255,8496,5,98,33,33,13,7463,687,13,98,351,49,93,194,202,219,65,7,28,29,32,9,1
"3960",910,61345,28,97,638,50,5,4513,540,10368,17,97,72,58,11,6774,1450,45,97,710,108,93,404,402,464,161,19,28,28,32,11,1
"3962",324,61091,17,95,242,28,9,4944,193,10099,1,99,37,27,14,9097,517,18,97,279,55,89,132,189,129,57,10,26,37,25,11,2
"3964",62,57757,2,97,48,0,0,NA,32,11547,2,94,5,6,19,8067,94,4,96,53,6,94,24,26,35,0,0,26,28,37,0,0
"3965",65,48644,5,92,54,6,9,4205,26,6546,0,100,0,3,12,8869,91,5,95,54,9,90,24,23,38,0,0,26,25,42,0,0
"3966",189,59257,10,95,143,10,5,5438,101,11656,4,96,23,10,10,7764,290,14,95,166,20,93,71,83,98,32,6,24,29,34,11,2
"3967",41,52575,2,95,31,3,7,5335,28,8936,2,93,3,3,11,7092,69,4,94,34,6,91,21,21,23,0,0,30,30,33,0,0
"3971",1390,60316,49,96,1037,86,6,4704,687,10072,18,97,86,93,14,7627,2077,67,97,1123,179,91,530,597,709,209,32,26,29,34,10,2
"3975",6595,60774,234,96,4362,257,4,4638,1713,11358,36,98,296,237,14,7178,8308,270,97,4658,494,94,1347,1864,3687,1363,47,16,22,44,16,1
"3976",9746,51976,242,98,7712,720,7,4679,2892,12301,28,99,513,659,23,7092,12638,270,98,8225,1379,89,2163,3413,6037,1000,25,17,27,48,8,0
"3977",40044,58733,1429,96,28309,2139,5,4547,10661,12421,236,98,1793,1852,17,7021,50705,1665,97,30102,3991,92,7903,12422,23396,6592,392,16,24,46,13,1
"3978",4856,61979,201,96,3211,193,4,4331,1165,11649,21,98,173,184,16,6774,6021,222,96,3384,377,94,890,1261,2861,954,55,15,21,48,16,1
"3979",134,53183,4,97,96,4,3,5314,65,12629,0,100,21,2,3,5986,199,4,98,117,6,97,39,73,69,0,0,20,37,35,0,0
"3980",1493,61278,64,96,1012,54,4,3875,402,12356,11,97,84,59,15,6745,1895,75,96,1096,113,94,280,483,831,271,30,15,25,44,14,2
"3981",2035,61932,67,97,1421,86,4,4310,653,11539,14,98,114,69,11,5724,2688,81,97,1535,155,94,474,705,1136,346,27,18,26,42,13,1
"3984",1779,56417,63,96,1305,142,8,4994,825,11813,15,98,143,126,15,7677,2604,78,97,1448,268,90,548,822,929,287,18,21,32,36,11,1
"3987",602,56760,17,97,438,32,5,5960,236,8189,4,98,24,28,12,7172,838,21,97,462,60,93,190,242,297,102,7,23,29,35,12,1
"3988",440,55767,15,97,327,23,5,5379,252,10852,5,98,56,25,10,8447,692,20,97,383,48,93,180,220,220,66,6,26,32,32,10,1
"3990",63,57461,6,90,44,3,5,1870,42,10805,1,98,5,2,5,7648,105,7,93,49,5,95,31,26,37,0,0,30,25,35,0,0
"3991",128,52440,10,92,98,9,7,2048,85,11273,3,96,8,9,11,6136,213,13,94,106,18,92,66,63,62,0,0,31,30,29,0,0
"3992",306,52394,6,98,237,27,9,5570,141,12902,1,99,23,25,18,9727,447,7,98,260,52,88,102,150,158,0,0,23,34,35,0,0
"3995",3410,54242,114,97,2653,316,9,4786,1624,12201,37,98,251,291,18,7365,5034,151,97,2904,607,88,1158,1625,1791,416,44,23,32,36,8,1
"3996",1982,65937,83,96,1318,100,5,4653,1049,12117,22,98,145,105,10,8243,3031,105,97,1463,205,93,763,850,966,387,65,25,28,32,13,2
"VIC other",5653,70793,282,95,3582,251,4,4853,2175,9582,64,97,302,253,12,7828,7828,346,96,3884,504,94,NA,NA,NA,NA,NA,NA,NA,NA,NA,NA
